Account_No,Withdrawal_amount,Deposit_amount,Balance_amount,Value_date,Data,transaction_details
40906174,10946,0,35953,2016-01-01,2016-01-01,Entertainment
40906174,0,908145,944098,2016-01-01,2016-01-01,
40906174,17385,0,-926713,2016-01-01,2016-01-01,Entertainment
40906174,16758,0,-943471,2016-01-02,2016-01-02,Entertainment
40906174,0,562835,-380636,2016-01-03,2016-01-03,
40906174,17708,0,-398344,2016-01-03,2016-01-03,Rent
40906174,0,479406,-81062,2016-01-03,2016-01-03,
40906174,15290,0,-96352,2016-01-04,2016-01-04,Rent
40906174,0,610569,-514217,2016-01-04,2016-01-04,
40906174,10897,0,-525114,2016-01-05,2016-01-05,Education
40906174,567469,0,-1092583,2016-01-05,2016-01-05,Education
40906174,15692,0,-1108275,2016-01-06,2016-01-06,Education
40906174,0,439015,-669260,2016-01-07,2016-01-07,
40906174,0,956436,-287176,2016-01-07,2016-01-07,
40906174,0,819629,-532453,2016-01-08,2016-01-08,
40906174,17909,0,-550362,2016-01-08,2016-01-08,Healthcare
40906174,15418,0,-565780,2016-01-08,2016-01-08,Groceries
40906174,0,546099,-19681,2016-01-09,2016-01-09,
40906174,0,742911,723230,2016-01-10,2016-01-10,
40906174,18307,0,-704923,2016-01-10,2016-01-10,Utilities
40906174,0,746664,41741,2016-01-11,2016-01-11,
40906174,10244,0,31497,2016-01-11,2016-01-11,Education
40906174,0,601161,632658,2016-01-11,2016-01-11,
40906174,0,444063,1076721,2016-01-12,2016-01-12,
40906174,736286,0,-340435,2016-01-12,2016-01-12,Groceries
40906174,0,813516,473081,2016-01-12,2016-01-12,
40906174,930791,0,-457710,2016-01-13,2016-01-13,Groceries
40906174,0,11212,-446498,2016-01-13,2016-01-13,
40906174,0,668849,-222351,2016-01-13,2016-01-13,
40906174,447233,0,-669584,2016-01-14,2016-01-14,Transportation
40906174,0,624983,-1380809,2016-01-15,2016-01-15,
40906174,0,535366,-845443,2016-01-16,2016-01-16,
40906174,0,781414,-863341,2016-01-17,2016-01-17,
40906174,0,951024,-87683,2016-01-17,2016-01-17,
40906174,19047,0,-106730,2016-01-18,2016-01-18,Healthcare
40906174,0,13358,-93372,2016-01-18,2016-01-18,
40906174,15580,0,-108952,2016-01-18,2016-01-18,Clothes
40906174,11517,0,-120469,2016-01-19,2016-01-19,Groceries
40906174,13206,0,-133675,2016-01-19,2016-01-19,Healthcare
40906174,0,797153,-663478,2016-01-20,2016-01-20,
40906174,0,876913,213435,2016-01-20,2016-01-20,
40906174,14082,0,199353,2016-01-20,2016-01-20,Rent
40906174,0,538860,738213,2016-01-21,2016-01-21,
40906174,0,13877,752090,2016-01-21,2016-01-21,
40906174,10225,0,-741865,2016-01-22,2016-01-22,Rent
40906174,0,11087,-730778,2016-01-23,2016-01-23,
40906174,0,836591,-1388868,2016-01-23,2016-01-23,
40906174,415121,0,-1803989,2016-01-24,2016-01-24,Utilities
40906174,13213,0,-1817202,2016-01-25,2016-01-25,Entertainment
40906174,11164,0,-1828366,2016-01-25,2016-01-25,Education
40906174,0,829613,-998753,2016-01-25,2016-01-25,
40906174,691217,0,-1689970,2016-01-26,2016-01-26,Groceries
40906174,0,19734,-1670236,2016-01-27,2016-01-27,
40906174,912698,0,-2582934,2016-01-28,2016-01-28,Clothes
40906174,19270,0,-2602204,2016-01-28,2016-01-28,Entertainment
40906174,0,831911,-1770293,2016-01-29,2016-01-29,
40906174,0,19656,-1750637,2016-01-29,2016-01-29,
40906174,12261,0,-1762898,2016-01-29,2016-01-29,Healthcare
40906174,882140,0,-2645038,2016-01-30,2016-01-30,Transportation
40906174,0,615810,-2029228,2016-01-30,2016-01-30,
40906174,818254,0,-2847482,2016-01-31,2016-01-31,Transportation
40906174,0,968980,-1878502,2016-01-31,2016-01-31,
40906174,0,14780,-1863722,2016-02-01,2016-02-01,
40906174,12689,0,-1876411,2016-02-02,2016-02-02,Healthcare
40906174,902194,0,-2778605,2016-02-02,2016-02-02,Utilities
40906174,0,12041,-2766564,2016-02-03,2016-02-03,
40906174,684530,0,-3451094,2016-02-03,2016-02-03,Education
40906174,778208,0,-4229302,2016-02-03,2016-02-03,Entertainment
40906174,0,690061,-3539241,2016-02-04,2016-02-04,
40906174,989806,0,-4529047,2016-02-04,2016-02-04,Rent
40906174,0,586273,-3942774,2016-02-05,2016-02-05,
40906174,19952,0,-3962726,2016-02-06,2016-02-06,Transportation
40906174,0,10148,-3952578,2016-02-06,2016-02-06,
40906174,724060,0,-4676638,2016-02-07,2016-02-07,Clothes
40906174,595523,0,-5272161,2016-02-08,2016-02-08,Utilities
40906174,0,11657,-5260504,2016-02-09,2016-02-09,
40906174,0,11159,-5249345,2016-02-09,2016-02-09,
40906174,530302,0,-5779647,2016-02-10,2016-02-10,Entertainment
40906174,0,530250,-5249397,2016-02-10,2016-02-10,
40906174,0,10253,-5239144,2016-02-10,2016-02-10,
40906174,18000,0,-5257144,2016-02-11,2016-02-11,Education
40906174,598859,0,-5856003,2016-02-12,2016-02-12,Clothes
40906174,432094,0,-6288097,2016-02-12,2016-02-12,Healthcare
40906174,915993,0,-7204090,2016-02-12,2016-02-12,Entertainment
40906174,0,860709,-6343381,2016-02-13,2016-02-13,
40906174,10211,0,-6353592,2016-02-13,2016-02-13,Entertainment
40906174,0,10259,-6343333,2016-02-13,2016-02-13,
40906174,844759,0,-7188092,2016-02-14,2016-02-14,Rent
40906174,0,901995,-6286097,2016-02-14,2016-02-14,
40906174,0,951972,-5334125,2016-02-14,2016-02-14,
40906174,549201,0,-5883326,2016-02-15,2016-02-15,Entertainment
40906174,16006,0,-5899332,2016-02-16,2016-02-16,Transportation
40906174,821397,0,-6720729,2016-02-17,2016-02-17,Transportation
40906174,0,520296,-6200433,2016-02-17,2016-02-17,
40906174,0,448382,-5752051,2016-02-17,2016-02-17,
40906174,887591,0,-6639642,2016-02-18,2016-02-18,Rent
40906174,0,877765,-5761877,2016-02-18,2016-02-18,
40906174,0,774948,-4986929,2016-02-19,2016-02-19,
40906174,0,786021,-4200908,2016-02-19,2016-02-19,
40906174,541083,0,-4741991,2016-02-20,2016-02-20,Clothes
40906174,0,845438,-4730714,2016-02-20,2016-02-20,
40906174,646723,0,-5377437,2016-02-21,2016-02-21,Healthcare
40906174,0,462062,-4915375,2016-02-21,2016-02-21,
40906174,639933,0,-5555308,2016-02-22,2016-02-22,Transportation
40906174,911753,0,-6467061,2016-02-22,2016-02-22,Groceries
40906174,19114,0,-6486175,2016-02-22,2016-02-22,Education
40906174,481619,0,-6967794,2016-02-23,2016-02-23,Rent
40906174,16479,0,-6984273,2016-02-24,2016-02-24,Rent
40906174,0,12382,-6971891,2016-02-24,2016-02-24,
40906174,583214,0,-7555105,2016-02-24,2016-02-24,Utilities
40906174,0,14761,-7540344,2016-02-25,2016-02-25,
40906174,633595,0,-8173939,2016-02-25,2016-02-25,Rent
40906174,0,18364,-8155575,2016-02-25,2016-02-25,
40906174,18133,0,-8173708,2016-02-26,2016-02-26,Education
40906174,545745,0,-8719453,2016-02-26,2016-02-26,Groceries
40906174,530382,0,-9249835,2016-02-26,2016-02-26,Education
40906174,0,867606,-8382229,2016-02-27,2016-02-27,
40906174,0,529801,-7852428,2016-02-27,2016-02-27,
40906174,462190,0,-8314618,2016-02-28,2016-02-28,Healthcare
40906174,769324,0,-9083942,2016-02-28,2016-02-28,Groceries
40906174,0,533467,-8550475,2016-02-28,2016-02-28,
40906174,0,680755,-7869720,2016-02-29,2016-02-29,
40906174,0,936452,-6933268,2016-03-01,2016-03-01,
40906174,0,15190,-6918078,2016-03-02,2016-03-02,
40906174,0,701604,-6216474,2016-03-03,2016-03-03,
40906174,0,861079,-6668444,2016-03-03,2016-03-03,
40906174,939038,0,-7607482,2016-03-03,2016-03-03,Clothes
40906174,0,10103,-7597379,2016-03-04,2016-03-04,
40906174,14329,0,-7611708,2016-03-04,2016-03-04,Transportation
40906174,0,780532,-6831176,2016-03-05,2016-03-05,
40906174,0,656985,-6174191,2016-03-05,2016-03-05,
40906174,948962,0,-7123153,2016-03-05,2016-03-05,Groceries
40906174,0,974201,-6148952,2016-03-06,2016-03-06,
40906174,0,911740,-5237212,2016-03-06,2016-03-06,
40906174,506702,0,-5743914,2016-03-06,2016-03-06,Education
40906174,0,667107,-5076807,2016-03-07,2016-03-07,
40906174,423056,0,-5499863,2016-03-07,2016-03-07,Clothes
40906174,10982,0,-5510845,2016-03-08,2016-03-08,Education
40906174,493753,0,-6004598,2016-03-08,2016-03-08,Bill Sharing
40906174,12186,0,-6016784,2016-03-09,2016-03-09,Healthcare
40906174,820937,0,-6837721,2016-03-09,2016-03-09,Transportation
40906174,0,693849,-7740945,2016-03-09,2016-03-09,
40906174,0,571113,-7169832,2016-03-10,2016-03-10,
40906174,664554,0,-7834386,2016-03-10,2016-03-10,Education
40906174,694601,0,-8528987,2016-03-10,2016-03-10,Utilities
40906174,0,844652,-7684335,2016-03-11,2016-03-11,
40906174,0,15463,-7668872,2016-03-11,2016-03-11,
40906174,621996,0,-8290868,2016-03-12,2016-03-12,Groceries
40906174,12994,0,-8303862,2016-03-13,2016-03-13,Clothes
40906174,12978,0,-8316840,2016-03-14,2016-03-14,Clothes
40906174,0,13205,-8303635,2016-03-15,2016-03-15,
40906174,494252,0,-8797887,2016-03-16,2016-03-16,Clothes
40906174,0,431674,-8366213,2016-03-17,2016-03-17,
40906174,0,875084,-7491129,2016-03-18,2016-03-18,
40906174,0,832094,-6659035,2016-03-18,2016-03-18,
40906174,0,889864,-5769171,2016-03-18,2016-03-18,
40906174,0,14224,-5754947,2016-03-19,2016-03-19,
40906174,443779,0,-6198726,2016-03-19,2016-03-19,Utilities
40906174,473581,0,-6672307,2016-03-20,2016-03-20,Utilities
40906174,13220,0,-6685527,2016-03-21,2016-03-21,Clothes
40906174,0,17353,-6668174,2016-03-21,2016-03-21,
40906174,0,925367,-5742807,2016-03-22,2016-03-22,
40906174,647276,0,-6390083,2016-03-22,2016-03-22,Clothes
40906174,0,439788,-5950295,2016-03-23,2016-03-23,
40906174,530726,0,-6481021,2016-03-23,2016-03-23,Utilities
40906174,18185,0,-6499206,2016-03-23,2016-03-23,Bill Sharing
40906174,0,507920,-5991286,2016-03-24,2016-03-24,
40906174,15222,0,-6006508,2016-03-25,2016-03-25,Education
40906174,10285,0,-6016793,2016-03-26,2016-03-26,Education
40906174,0,11886,-6004907,2016-03-27,2016-03-27,
40906174,0,727913,-5276994,2016-03-27,2016-03-27,
40906174,12977,0,-5289971,2016-03-27,2016-03-27,Clothes
40906174,931006,0,-6220977,2016-03-28,2016-03-28,Transportation
40906174,0,15534,-6205443,2016-03-29,2016-03-29,
40906174,975021,0,-7180464,2016-03-29,2016-03-29,Groceries
40906174,10353,0,-7190817,2016-03-30,2016-03-30,Entertainment
40906174,754158,0,-7944975,2016-03-31,2016-03-31,Bill Sharing
40906174,13746,0,-7958721,2016-04-01,2016-04-01,Bill Sharing
40906174,0,12372,-7946349,2016-04-01,2016-04-01,
40906174,0,10380,-7935969,2016-04-01,2016-04-01,
40906174,11083,0,-7947052,2016-04-02,2016-04-02,Bill Sharing
40906174,0,798761,-7148291,2016-04-02,2016-04-02,
40906174,0,614663,-6533628,2016-04-02,2016-04-02,
40906174,0,19333,-6514295,2016-04-03,2016-04-03,
40906174,0,401436,-5835539,2016-04-04,2016-04-04,
40906174,10049,0,-5845588,2016-04-04,2016-04-04,Clothes
40906174,0,988673,-4856915,2016-04-04,2016-04-04,
40906174,0,13088,-4843827,2016-04-05,2016-04-05,
40906174,487242,0,-5331069,2016-04-05,2016-04-05,Bill Sharing
40906174,16160,0,-5347229,2016-04-06,2016-04-06,Bill Sharing
40906174,14530,0,-5361759,2016-04-06,2016-04-06,Clothes
40906174,18923,0,-5380682,2016-04-07,2016-04-07,Education
40906174,0,952950,-4427732,2016-04-07,2016-04-07,
40906174,0,13047,-4414685,2016-04-08,2016-04-08,
40906174,0,475168,-3939517,2016-04-09,2016-04-09,
40906174,0,707918,-3231599,2016-04-09,2016-04-09,
40906174,416609,0,-3648208,2016-04-10,2016-04-10,Rent
40906174,0,660742,-2987466,2016-04-11,2016-04-11,
40906174,0,755149,-2232317,2016-04-12,2016-04-12,
40906174,0,926881,-1305436,2016-04-13,2016-04-13,
40906174,0,19339,-1286097,2016-04-14,2016-04-14,
40906174,0,13441,-1272656,2016-04-15,2016-04-15,
40906174,483596,0,-1756252,2016-04-15,2016-04-15,Entertainment
40906174,0,17449,-1738803,2016-04-15,2016-04-15,
40906174,761944,0,-2500747,2016-04-16,2016-04-16,Bill Sharing
40906174,832688,0,-3333435,2016-04-16,2016-04-16,Healthcare
40906174,0,16479,-3316956,2016-04-16,2016-04-16,
40906174,465527,0,-3825735,2016-04-17,2016-04-17,Healthcare
40906174,0,816975,-3008760,2016-04-17,2016-04-17,
40906174,0,717273,-2291487,2016-04-17,2016-04-17,
40906174,0,537115,-1754372,2016-04-18,2016-04-18,
40906174,18545,0,-1772917,2016-04-19,2016-04-19,Education
40906174,13691,0,-1786608,2016-04-19,2016-04-19,Rent
40906174,0,508951,-1277657,2016-04-19,2016-04-19,
40906174,17557,0,-1295214,2016-04-20,2016-04-20,Transportation
40906174,0,12219,-1282995,2016-04-21,2016-04-21,
40906174,908861,0,-2191856,2016-04-21,2016-04-21,Education
40906174,0,737350,-1454506,2016-04-21,2016-04-21,
40906174,0,17713,-1436793,2016-04-22,2016-04-22,
40906174,0,493240,-943553,2016-04-22,2016-04-22,
40906174,0,677213,-930036,2016-04-23,2016-04-23,
40906174,0,678005,-252031,2016-04-23,2016-04-23,
40906174,708374,0,-960405,2016-04-23,2016-04-23,Entertainment
40906174,17443,0,-977848,2016-04-24,2016-04-24,Rent
40906174,15591,0,-993439,2016-04-24,2016-04-24,Education
40906174,0,12099,-981340,2016-04-24,2016-04-24,
40906174,12417,0,-993757,2016-04-25,2016-04-25,Bill Sharing
40906174,0,476830,-516927,2016-04-25,2016-04-25,
40906174,16161,0,-533088,2016-04-26,2016-04-26,Education
40906174,529798,0,-1062886,2016-04-26,2016-04-26,Transportation
40906174,547761,0,-1610647,2016-04-26,2016-04-26,Bill Sharing
40906174,0,15590,-1595057,2016-04-27,2016-04-27,
40906174,723702,0,-2318759,2016-04-27,2016-04-27,Entertainment
40906174,0,625750,-1693009,2016-04-27,2016-04-27,
40906174,0,12595,-1680414,2016-04-28,2016-04-28,
40906174,0,18664,-1661750,2016-04-29,2016-04-29,
40906174,0,17981,-1643769,2016-04-30,2016-04-30,
40906174,0,441150,-1202619,2016-04-30,2016-04-30,
40906174,0,452826,-749793,2016-05-01,2016-05-01,
40906174,558533,0,-1308326,2016-05-01,2016-05-01,Healthcare
40906174,0,557800,-750526,2016-05-01,2016-05-01,
40906174,850704,0,-1601230,2016-05-02,2016-05-02,Healthcare
40906174,0,17072,-1584158,2016-05-03,2016-05-03,
40906174,18136,0,-1602294,2016-05-03,2016-05-03,Education
40906174,0,694474,-907820,2016-05-03,2016-05-03,
40906174,0,10195,-897625,2016-05-04,2016-05-04,
40906174,817419,0,-1715044,2016-05-05,2016-05-05,Utilities
40906174,0,10272,-1704772,2016-05-05,2016-05-05,
40906174,0,14430,-1690342,2016-05-06,2016-05-06,
40906174,0,11349,-1678993,2016-05-07,2016-05-07,
40906174,0,468791,-1210202,2016-05-07,2016-05-07,
40906174,890726,0,-2100928,2016-05-07,2016-05-07,Entertainment
40906174,0,761120,-1339808,2016-05-08,2016-05-08,
40906174,479402,0,-2056373,2016-05-08,2016-05-08,Education
40906174,11252,0,-2067625,2016-05-09,2016-05-09,Groceries
40906174,0,914201,-1153424,2016-05-09,2016-05-09,
40906174,0,735604,-417820,2016-05-10,2016-05-10,
40906174,0,547520,129700,2016-05-10,2016-05-10,
40906174,0,475989,605689,2016-05-10,2016-05-10,
40906174,726628,0,-120939,2016-05-11,2016-05-11,Groceries
40906174,0,19329,-101610,2016-05-12,2016-05-12,
40906174,0,960133,858523,2016-05-13,2016-05-13,
40906174,0,651273,1509796,2016-05-13,2016-05-13,
40906174,0,457073,1966869,2016-05-14,2016-05-14,
40906174,543901,0,1422968,2016-05-14,2016-05-14,Utilities
40906174,11047,0,1411921,2016-05-14,2016-05-14,Rent
40906174,0,15979,1427900,2016-05-15,2016-05-15,
40906174,12582,0,1415318,2016-05-15,2016-05-15,Entertainment
40906174,621538,0,793780,2016-05-16,2016-05-16,Bill Sharing
40906174,900803,0,-191854,2016-05-16,2016-05-16,Healthcare
40906174,743226,0,-935080,2016-05-16,2016-05-16,Rent
40906174,468591,0,-1403671,2016-05-17,2016-05-17,Clothes
40906174,17309,0,-1420980,2016-05-18,2016-05-18,Rent
40906174,0,815450,-605530,2016-05-19,2016-05-19,
40906174,0,408611,-196919,2016-05-19,2016-05-19,
40906174,484814,0,-681733,2016-05-20,2016-05-20,Healthcare
40906174,0,490908,-190825,2016-05-20,2016-05-20,
40906174,0,18740,-172085,2016-05-21,2016-05-21,
40906174,0,831173,-659088,2016-05-21,2016-05-21,
40906174,536836,0,-1195924,2016-05-22,2016-05-22,Healthcare
40906174,18592,0,-1214516,2016-05-23,2016-05-23,Utilities
40906174,991976,0,-2206492,2016-05-23,2016-05-23,Rent
40906174,0,12687,-2193805,2016-05-23,2016-05-23,
40906174,18018,0,-2211823,2016-05-24,2016-05-24,Healthcare
40906174,11178,0,-2223001,2016-05-24,2016-05-24,Rent
40906174,0,13265,-2209736,2016-05-24,2016-05-24,
40906174,615319,0,-2825055,2016-05-25,2016-05-25,Rent
40906174,0,818829,-2006226,2016-05-26,2016-05-26,
40906174,0,16538,-1989688,2016-05-27,2016-05-27,
40906174,13779,0,-2003467,2016-05-27,2016-05-27,Education
40906174,0,480457,-1523010,2016-05-28,2016-05-28,
40906174,0,12542,-1510468,2016-05-28,2016-05-28,
40906174,0,528649,-981819,2016-05-29,2016-05-29,
40906174,707255,0,-1689074,2016-05-29,2016-05-29,Utilities
40906174,13857,0,-1702931,2016-05-30,2016-05-30,Rent
40906174,0,10870,-1692061,2016-05-30,2016-05-30,
40906174,645394,0,-2337455,2016-05-30,2016-05-30,Transportation
40906174,909764,0,-3247219,2016-05-31,2016-05-31,Bill Sharing
40906174,877773,0,-4124992,2016-06-01,2016-06-01,Entertainment
40906174,0,414812,-4143001,2016-06-01,2016-06-01,
40906174,0,885525,-4157990,2016-06-02,2016-06-02,
40906174,10479,0,-4168469,2016-06-02,2016-06-02,Healthcare
40906174,0,18994,-4149475,2016-06-03,2016-06-03,
40906174,0,401019,-3748456,2016-06-04,2016-06-04,
40906174,10948,0,-3759404,2016-06-05,2016-06-05,Rent
40906174,0,16590,-3742814,2016-06-05,2016-06-05,
40906174,892426,0,-4635240,2016-06-05,2016-06-05,Clothes
40906174,17979,0,-4653219,2016-06-06,2016-06-06,Entertainment
40906174,0,817357,-3835862,2016-06-06,2016-06-06,
40906174,0,904376,-2931486,2016-06-07,2016-06-07,
40906174,13626,0,-2945112,2016-06-08,2016-06-08,Rent
40906174,704550,0,-3649662,2016-06-09,2016-06-09,Groceries
40906174,16672,0,-3666334,2016-06-09,2016-06-09,Clothes
40906174,19996,0,-3686330,2016-06-10,2016-06-10,Bill Sharing
40906174,755363,0,-4441693,2016-06-10,2016-06-10,Utilities
40906174,0,543928,-3897765,2016-06-11,2016-06-11,
40906174,0,444921,-3452844,2016-06-11,2016-06-11,
40906174,0,568433,-2884411,2016-06-12,2016-06-12,
40906174,581564,0,-3465975,2016-06-13,2016-06-13,Rent
40906174,0,15430,-3450545,2016-06-13,2016-06-13,
40906174,0,668062,-2782483,2016-06-14,2016-06-14,
40906174,0,14816,-2767667,2016-06-14,2016-06-14,
40906174,0,689696,-2077971,2016-06-14,2016-06-14,
40906174,0,636604,-1441367,2016-06-15,2016-06-15,
40906174,693558,0,-2134925,2016-06-15,2016-06-15,Education
40906174,0,15439,-2119486,2016-06-16,2016-06-16,
40906174,0,589886,-1529600,2016-06-16,2016-06-16,
40906174,0,879321,-1518608,2016-06-16,2016-06-16,
40906174,0,963943,-554665,2016-06-17,2016-06-17,
40906174,13893,0,-568558,2016-06-17,2016-06-17,Education
40906174,17280,0,-585838,2016-06-17,2016-06-17,Entertainment
40906174,19528,0,-605366,2016-06-18,2016-06-18,Clothes
40906174,0,906799,-301433,2016-06-18,2016-06-18,
40906174,0,18349,-283084,2016-06-18,2016-06-18,
40906174,0,17091,-265993,2016-06-19,2016-06-19,
40906174,0,883648,-617655,2016-06-19,2016-06-19,
40906174,494853,0,-1112508,2016-06-19,2016-06-19,Groceries
40906174,12455,0,-1124963,2016-06-20,2016-06-20,Clothes
40906174,684168,0,-1809131,2016-06-21,2016-06-21,Healthcare
40906174,0,540392,-1268739,2016-06-21,2016-06-21,
40906174,580911,0,-1849650,2016-06-21,2016-06-21,Entertainment
40906174,0,831849,-1017801,2016-06-22,2016-06-22,
40906174,0,990344,-27457,2016-06-23,2016-06-23,
40906174,0,817486,-790029,2016-06-23,2016-06-23,
40906174,16933,0,-806962,2016-06-24,2016-06-24,Rent
40906174,0,839258,-32296,2016-06-24,2016-06-24,
40906174,705966,0,-487854,2016-06-25,2016-06-25,Education
40906174,0,17105,-470749,2016-06-25,2016-06-25,
40906174,0,790731,-319982,2016-06-25,2016-06-25,
40906174,0,704323,-384341,2016-06-26,2016-06-26,
40906174,0,14749,-369592,2016-06-27,2016-06-27,
40906174,0,18913,-350679,2016-06-27,2016-06-27,
40906174,0,19826,-330853,2016-06-28,2016-06-28,
40906174,0,743790,-412937,2016-06-28,2016-06-28,
40906174,10288,0,-423225,2016-06-29,2016-06-29,Entertainment
40906174,768326,0,-1191551,2016-06-29,2016-06-29,Clothes
40906174,827774,0,-269981,2016-06-29,2016-06-29,Healthcare
40906174,11592,0,-281573,2016-06-30,2016-06-30,Entertainment
40906174,13944,0,-295517,2016-06-30,2016-06-30,Rent
40906174,15766,0,-311283,2016-07-01,2016-07-01,Groceries
40906174,602103,0,-913386,2016-07-02,2016-07-02,Utilities
40906174,897290,0,-1810676,2016-07-03,2016-07-03,Healthcare
40906174,0,15230,-1795446,2016-07-04,2016-07-04,
40906174,804523,0,-2599969,2016-07-04,2016-07-04,Bill Sharing
40906174,559302,0,-3159271,2016-07-04,2016-07-04,Healthcare
40906174,0,501609,-2657662,2016-07-05,2016-07-05,
40906174,618071,0,-3275733,2016-07-06,2016-07-06,Utilities
40906174,616473,0,-3892206,2016-07-07,2016-07-07,Education
40906174,0,889411,-3002795,2016-07-07,2016-07-07,
40906174,574564,0,-3577359,2016-07-08,2016-07-08,Education
40906174,674839,0,-4252198,2016-07-08,2016-07-08,Entertainment
40906174,0,549885,-3702313,2016-07-09,2016-07-09,
40906174,0,525542,-3176771,2016-07-09,2016-07-09,
40906174,0,16482,-3160289,2016-07-09,2016-07-09,
40906174,0,19312,-3140977,2016-07-10,2016-07-10,
40906174,785756,0,-3926733,2016-07-10,2016-07-10,Utilities
40906174,645449,0,-4572182,2016-07-11,2016-07-11,Utilities
40906174,983249,0,-5555431,2016-07-11,2016-07-11,Entertainment
40906174,17363,0,-5572794,2016-07-12,2016-07-12,Bill Sharing
40906174,10461,0,-5583255,2016-07-12,2016-07-12,Rent
40906174,474577,0,-5596216,2016-07-12,2016-07-12,Education
40906174,19293,0,-5615509,2016-07-13,2016-07-13,Entertainment
40906174,18434,0,-5633943,2016-07-13,2016-07-13,Bill Sharing
40906174,981899,0,-6615842,2016-07-14,2016-07-14,Utilities
40906174,509186,0,-7125028,2016-07-14,2016-07-14,Healthcare
40906174,716226,0,-7841254,2016-07-15,2016-07-15,Groceries
40906174,0,452228,-7389026,2016-07-16,2016-07-16,
40906174,0,11233,-7377793,2016-07-17,2016-07-17,
40906174,0,16098,-7361695,2016-07-17,2016-07-17,
40906174,522381,0,-7884076,2016-07-18,2016-07-18,Rent
40906174,949807,0,-8833883,2016-07-19,2016-07-19,Healthcare
40906174,0,828360,-8005523,2016-07-20,2016-07-20,
40906174,706466,0,-8711989,2016-07-20,2016-07-20,Transportation
40906174,12500,0,-8724489,2016-07-20,2016-07-20,Clothes
40906174,0,467444,-8257045,2016-07-21,2016-07-21,
40906174,0,18424,-8238621,2016-07-22,2016-07-22,
40906174,0,463164,-7775457,2016-07-23,2016-07-23,
40906174,806163,0,-8581620,2016-07-23,2016-07-23,Entertainment
40906174,615975,0,-9197595,2016-07-24,2016-07-24,Healthcare
40906174,0,895151,-9654291,2016-07-25,2016-07-25,
40906174,14034,0,-9668325,2016-07-26,2016-07-26,Transportation
40906174,0,549700,-9118625,2016-07-26,2016-07-26,
40906174,0,639682,-8478943,2016-07-27,2016-07-27,
40906174,435255,0,-8914198,2016-07-27,2016-07-27,Clothes
40906174,0,16212,-8897986,2016-07-28,2016-07-28,
40906174,12315,0,-8910301,2016-07-29,2016-07-29,Entertainment
40906174,0,471597,-8438704,2016-07-30,2016-07-30,
40906174,651217,0,-9089921,2016-07-31,2016-07-31,Clothes
40906174,517715,0,-9607636,2016-07-31,2016-07-31,Healthcare
40906174,0,976785,-8630851,2016-08-01,2016-08-01,
40906174,0,19274,-8611577,2016-08-01,2016-08-01,
40906174,520419,0,-9131996,2016-08-02,2016-08-02,Bill Sharing
40906174,0,14451,-9117545,2016-08-02,2016-08-02,
40906174,752162,0,-9869707,2016-08-03,2016-08-03,Education
40906174,650634,0,-10520341,2016-08-03,2016-08-03,Rent
40906174,14367,0,-10534708,2016-08-04,2016-08-04,Groceries
40906174,801333,0,-11336041,2016-08-04,2016-08-04,Clothes
40906174,0,18078,-11317963,2016-08-04,2016-08-04,
40906174,551042,0,-11869005,2016-08-05,2016-08-05,Rent
40906174,15789,0,-11884794,2016-08-05,2016-08-05,Groceries
40906174,19107,0,-11903901,2016-08-05,2016-08-05,Transportation
40906174,15335,0,-11919236,2016-08-06,2016-08-06,Entertainment
40906174,556778,0,-12476014,2016-08-06,2016-08-06,Utilities
40906174,17687,0,-12493701,2016-08-06,2016-08-06,Groceries
40906174,0,908269,-11585432,2016-08-07,2016-08-07,
40906174,0,748166,-10837266,2016-08-07,2016-08-07,
40906174,0,543980,-10293286,2016-08-07,2016-08-07,
40906174,690735,0,-10984021,2016-08-08,2016-08-08,Healthcare
40906174,17211,0,-11001232,2016-08-08,2016-08-08,Groceries
40906174,0,18622,-10982610,2016-08-08,2016-08-08,
40906174,0,11379,-10971231,2016-08-09,2016-08-09,
40906174,11770,0,-10983001,2016-08-09,2016-08-09,Bill Sharing
40906174,0,15002,-10967999,2016-08-09,2016-08-09,
40906174,0,919523,-10048476,2016-08-10,2016-08-10,
40906174,848143,0,-10896619,2016-08-11,2016-08-11,Utilities
40906174,0,420987,-10475632,2016-08-12,2016-08-12,
40906174,0,11682,-10463950,2016-08-12,2016-08-12,
40906174,559335,0,-11023285,2016-08-13,2016-08-13,Clothes
40906174,0,895573,-10127712,2016-08-13,2016-08-13,
40906174,0,881912,-9245800,2016-08-14,2016-08-14,
40906174,766039,0,-10011839,2016-08-15,2016-08-15,Education
40906174,633118,0,-10644957,2016-08-16,2016-08-16,Clothes
40906174,19085,0,-10664042,2016-08-17,2016-08-17,Rent
40906174,0,12098,-10651944,2016-08-17,2016-08-17,
40906174,0,13398,-10638546,2016-08-17,2016-08-17,
40906174,15452,0,-10653998,2016-08-18,2016-08-18,Clothes
40906174,631919,0,-11285917,2016-08-18,2016-08-18,Utilities
40906174,932452,0,-12218369,2016-08-19,2016-08-19,Transportation
40906174,13752,0,-12232121,2016-08-19,2016-08-19,Bill Sharing
40906174,874665,0,-13106786,2016-08-20,2016-08-20,Clothes
40906174,0,538508,-13118752,2016-08-20,2016-08-20,
40906174,0,887990,-12230762,2016-08-20,2016-08-20,
40906174,0,554851,-11675911,2016-08-21,2016-08-21,
40906174,0,495416,-11180495,2016-08-21,2016-08-21,
40906174,0,822251,-10358244,2016-08-22,2016-08-22,
40906174,11077,0,-10369321,2016-08-22,2016-08-22,Bill Sharing
40906174,974509,0,-11343830,2016-08-22,2016-08-22,Utilities
40906174,0,985575,-10358255,2016-08-23,2016-08-23,
40906174,0,18510,-10339745,2016-08-24,2016-08-24,
40906174,16977,0,-10356722,2016-08-24,2016-08-24,Groceries
40906174,480317,0,-10837039,2016-08-24,2016-08-24,Transportation
40906174,11811,0,-10848850,2016-08-25,2016-08-25,Utilities
40906174,13934,0,-10862784,2016-08-26,2016-08-26,Utilities
40906174,0,815889,-10046895,2016-08-26,2016-08-26,
40906174,938627,0,-10985522,2016-08-27,2016-08-27,Entertainment
40906174,762393,0,-11747915,2016-08-28,2016-08-28,Utilities
40906174,0,420959,-11326956,2016-08-28,2016-08-28,
40906174,0,426248,-10900708,2016-08-28,2016-08-28,
40906174,0,437312,-10463396,2016-08-29,2016-08-29,
40906174,14156,0,-10477552,2016-08-29,2016-08-29,Transportation
40906174,940260,0,-9502780,2016-08-30,2016-08-30,Healthcare
40906174,0,15707,-9487073,2016-08-30,2016-08-30,
40906174,17303,0,-9504376,2016-08-30,2016-08-30,Groceries
40906174,0,611606,-8892770,2016-08-31,2016-08-31,
40906174,0,650752,-8242018,2016-08-31,2016-08-31,
40906174,10907,0,-8252925,2016-09-01,2016-09-01,Clothes
40906174,14262,0,-8267187,2016-09-01,2016-09-01,Utilities
40906174,0,18992,-8248195,2016-09-01,2016-09-01,
40906174,0,16706,-8231489,2016-09-02,2016-09-02,
40906174,19349,0,-8250838,2016-09-02,2016-09-02,Clothes
40906174,764621,0,-9015459,2016-09-02,2016-09-02,Groceries
40906174,0,436375,-8579084,2016-09-03,2016-09-03,
40906174,0,806213,-7772871,2016-09-03,2016-09-03,
40906174,0,972396,-6800475,2016-09-04,2016-09-04,
40906174,0,822037,-5978438,2016-09-04,2016-09-04,
40906174,0,761398,-5217040,2016-09-04,2016-09-04,
40906174,12976,0,-5230016,2016-09-05,2016-09-05,Bill Sharing
40906174,0,18811,-5211205,2016-09-05,2016-09-05,
40906174,0,892104,-4319101,2016-09-05,2016-09-05,
40906174,595187,0,-4914288,2016-09-06,2016-09-06,Healthcare
40906174,456932,0,-5371220,2016-09-06,2016-09-06,Clothes
40906174,0,561796,-4809424,2016-09-07,2016-09-07,
40906174,0,19724,-4789700,2016-09-08,2016-09-08,
40906174,0,10037,-4779663,2016-09-08,2016-09-08,
40906174,0,17269,-4762394,2016-09-08,2016-09-08,
40906174,824396,0,-4743049,2016-09-09,2016-09-09,Education
40906174,0,13465,-4729584,2016-09-09,2016-09-09,
40906174,17272,0,-4746856,2016-09-09,2016-09-09,Clothes
40906174,0,15838,-4731018,2016-09-10,2016-09-10,
40906174,0,919052,-4303884,2016-09-11,2016-09-11,
40906174,17551,0,-4321435,2016-09-11,2016-09-11,Entertainment
40906174,0,822953,-3498482,2016-09-12,2016-09-12,
40906174,712311,0,-4210793,2016-09-12,2016-09-12,Transportation
40906174,0,619001,-3591792,2016-09-12,2016-09-12,
40906174,0,765491,-2826301,2016-09-13,2016-09-13,
40906174,10798,0,-2837099,2016-09-13,2016-09-13,Clothes
40906174,0,10460,-2826639,2016-09-14,2016-09-14,
40906174,0,10643,-2815996,2016-09-14,2016-09-14,
40906174,645837,0,-3461833,2016-09-14,2016-09-14,Transportation
40906174,12452,0,-3474285,2016-09-15,2016-09-15,Groceries
40906174,0,641176,-2833109,2016-09-16,2016-09-16,
40906174,0,10345,-2822764,2016-09-16,2016-09-16,
40906174,0,831951,-1990813,2016-09-17,2016-09-17,
40906174,0,10649,-1980164,2016-09-18,2016-09-18,
40906174,568003,0,-2955595,2016-09-19,2016-09-19,Healthcare
40906174,0,430202,-2525393,2016-09-19,2016-09-19,
40906174,0,746721,-1778672,2016-09-20,2016-09-20,
40906174,912807,0,-2691479,2016-09-21,2016-09-21,Groceries
40906174,0,510407,-2181072,2016-09-22,2016-09-22,
40906174,0,13629,-2167443,2016-09-23,2016-09-23,
40906174,557340,0,-2724783,2016-09-23,2016-09-23,Healthcare
40906174,0,701188,-2023595,2016-09-24,2016-09-24,
40906174,0,17962,-2005633,2016-09-24,2016-09-24,
40906174,0,18126,-1987507,2016-09-24,2016-09-24,
40906174,834671,0,-2822178,2016-09-25,2016-09-25,Healthcare
40906174,12790,0,-2834968,2016-09-26,2016-09-26,Entertainment
40906174,918109,0,-3753077,2016-09-27,2016-09-27,Bill Sharing
40906174,908288,0,-4661365,2016-09-27,2016-09-27,Utilities
40906174,468620,0,-5286126,2016-09-28,2016-09-28,Education
40906174,14353,0,-5300479,2016-09-29,2016-09-29,Entertainment
40906174,427989,0,-5728468,2016-09-30,2016-09-30,Utilities
40906174,13188,0,-5741656,2016-10-01,2016-10-01,Education
40906174,13333,0,-5754989,2016-10-02,2016-10-02,Bill Sharing
40906174,19800,0,-5774789,2016-10-03,2016-10-03,Groceries
40906174,0,16692,-5758097,2016-10-04,2016-10-04,
40906174,721627,0,-5291528,2016-10-04,2016-10-04,Education
40906174,0,835304,-4456224,2016-10-04,2016-10-04,
40906174,0,19001,-4437223,2016-10-05,2016-10-05,
40906174,11677,0,-4448900,2016-10-05,2016-10-05,Rent
40906174,0,19725,-4429175,2016-10-06,2016-10-06,
40906174,501541,0,-4930716,2016-10-06,2016-10-06,Entertainment
40906174,10850,0,-4941566,2016-10-07,2016-10-07,Groceries
40906174,692258,0,-5633824,2016-10-07,2016-10-07,Healthcare
40906174,0,660257,-4973567,2016-10-07,2016-10-07,
40906174,541555,0,-5515122,2016-10-08,2016-10-08,Education
40906174,0,15256,-5499866,2016-10-08,2016-10-08,
40906174,0,17175,-5482691,2016-10-09,2016-10-09,
40906174,0,599625,-4883066,2016-10-09,2016-10-09,
40906174,0,790760,-4092306,2016-10-10,2016-10-10,
40906174,0,417778,-3674528,2016-10-10,2016-10-10,
40906174,15689,0,-3690217,2016-10-10,2016-10-10,Healthcare
40906174,707333,0,-4397550,2016-10-11,2016-10-11,Rent
40906174,0,16820,-4380730,2016-10-11,2016-10-11,
40906174,0,634592,-3746138,2016-10-12,2016-10-12,
40906174,0,900448,-2845690,2016-10-13,2016-10-13,
40906174,582927,0,-3428617,2016-10-13,2016-10-13,Bill Sharing
40906174,10184,0,-3438801,2016-10-13,2016-10-13,Entertainment
40906174,600617,0,-4039418,2016-10-14,2016-10-14,Rent
40906174,15307,0,-4054725,2016-10-14,2016-10-14,Education
40906174,659741,0,-4714466,2016-10-14,2016-10-14,Entertainment
40906174,0,18675,-4695791,2016-10-15,2016-10-15,
40906174,13108,0,-4708899,2016-10-15,2016-10-15,Utilities
40906174,992563,0,-5701462,2016-10-16,2016-10-16,Transportation
40906174,0,846472,-4854990,2016-10-17,2016-10-17,
40906174,0,17046,-4837944,2016-10-17,2016-10-17,
40906174,644712,0,-5482656,2016-10-18,2016-10-18,Bill Sharing
40906174,0,878428,-4604228,2016-10-18,2016-10-18,
40906174,0,676641,-3927587,2016-10-19,2016-10-19,
40906174,0,14176,-3913411,2016-10-19,2016-10-19,
40906174,0,15753,-3897658,2016-10-19,2016-10-19,
40906174,0,904673,-2992985,2016-10-20,2016-10-20,
40906174,540969,0,-3533954,2016-10-20,2016-10-20,Transportation
40906174,15705,0,-3549659,2016-10-21,2016-10-21,Rent
40906174,0,906745,-2642914,2016-10-22,2016-10-22,
40906174,0,18652,-2624262,2016-10-23,2016-10-23,
40906174,802072,0,-3426334,2016-10-23,2016-10-23,Utilities
40906174,14598,0,-3440932,2016-10-23,2016-10-23,Education
40906174,0,10812,-3430120,2016-10-24,2016-10-24,
40906174,968514,0,-4398634,2016-10-24,2016-10-24,Groceries
40906174,793218,0,-5191852,2016-10-24,2016-10-24,Groceries
40906174,15821,0,-5207673,2016-10-25,2016-10-25,Clothes
40906174,0,15534,-5192139,2016-10-26,2016-10-26,
40906174,747071,0,-5939210,2016-10-26,2016-10-26,Groceries
40906174,0,16200,-5923010,2016-10-27,2016-10-27,
40906174,0,16683,-5906327,2016-10-28,2016-10-28,
40906174,18190,0,-5924517,2016-10-28,2016-10-28,Clothes
40906174,916980,0,-6841497,2016-10-29,2016-10-29,Entertainment
40906174,501452,0,-7342949,2016-10-29,2016-10-29,Clothes
40906174,14139,0,-7357088,2016-10-29,2016-10-29,Entertainment
40906174,637722,0,-7994810,2016-10-30,2016-10-30,Education
40906174,0,424979,-7569831,2016-10-31,2016-10-31,
40906174,843713,0,-8413544,2016-10-31,2016-10-31,Education
40906174,914950,0,-9328494,2016-11-01,2016-11-01,Utilities
40906174,0,578915,-8749579,2016-11-01,2016-11-01,
40906174,528645,0,-9278224,2016-11-02,2016-11-02,Bill Sharing
40906174,16370,0,-9294594,2016-11-02,2016-11-02,Groceries
40906174,702436,0,-9997030,2016-11-03,2016-11-03,Utilities
40906174,854864,0,-10851894,2016-11-03,2016-11-03,Rent
40906174,723174,0,-11575068,2016-11-03,2016-11-03,Utilities
40906174,0,586881,-10988187,2016-11-04,2016-11-04,
40906174,0,462072,-10526115,2016-11-05,2016-11-05,
40906174,402808,0,-10928923,2016-11-05,2016-11-05,Groceries
40906174,0,724185,-10204738,2016-11-06,2016-11-06,
40906174,470215,0,-10674953,2016-11-06,2016-11-06,Healthcare
40906174,0,515473,-10159480,2016-11-06,2016-11-06,
40906174,0,11257,-10148223,2016-11-07,2016-11-07,
40906174,0,10824,-10137399,2016-11-07,2016-11-07,
40906174,0,652369,-9485030,2016-11-07,2016-11-07,
40906174,0,982903,-8502127,2016-11-08,2016-11-08,
40906174,0,16617,-8485510,2016-11-08,2016-11-08,
40906174,865795,0,-9351305,2016-11-08,2016-11-08,Transportation
40906174,0,780716,-8570589,2016-11-09,2016-11-09,
40906174,0,16345,-8554244,2016-11-09,2016-11-09,
40906174,776653,0,-9330897,2016-11-10,2016-11-10,Clothes
40906174,419031,0,-9749928,2016-11-10,2016-11-10,Healthcare
40906174,18967,0,-9768895,2016-11-10,2016-11-10,Bill Sharing
40906174,16531,0,-9785426,2016-11-11,2016-11-11,Utilities
40906174,580359,0,-10365785,2016-11-11,2016-11-11,Education
40906174,804120,0,-11169905,2016-11-12,2016-11-12,Education
40906174,672849,0,-11842754,2016-11-12,2016-11-12,Groceries
40906174,0,19472,-11823282,2016-11-12,2016-11-12,
40906174,514555,0,-12337837,2016-11-13,2016-11-13,Education
40906174,0,14330,-12323507,2016-11-13,2016-11-13,
40906174,0,13283,-12310224,2016-11-13,2016-11-13,
40906174,435120,0,-12745344,2016-11-14,2016-11-14,Education
40906174,901751,0,-13647095,2016-11-15,2016-11-15,Rent
40906174,531668,0,-14178763,2016-11-15,2016-11-15,Entertainment
40906174,0,443518,-13735245,2016-11-16,2016-11-16,
40906174,0,11574,-13723671,2016-11-17,2016-11-17,
40906174,0,932311,-12791360,2016-11-17,2016-11-17,
40906174,740034,0,-13531394,2016-11-18,2016-11-18,Entertainment
40906174,18784,0,-13550178,2016-11-19,2016-11-19,Healthcare
40906174,14695,0,-13564873,2016-11-19,2016-11-19,Education
40906174,10676,0,-13575549,2016-11-20,2016-11-20,Clothes
40906174,932358,0,-14507907,2016-11-20,2016-11-20,Healthcare
40906174,846383,0,-15354290,2016-11-21,2016-11-21,Education
40906174,885796,0,-16240086,2016-11-21,2016-11-21,Bill Sharing
40906174,816265,0,-16647169,2016-11-21,2016-11-21,Education
40906174,607804,0,-17254973,2016-11-22,2016-11-22,Rent
40906174,17841,0,-17272814,2016-11-22,2016-11-22,Rent
40906174,668171,0,-17940985,2016-11-22,2016-11-22,Entertainment
40906174,827260,0,-18768245,2016-11-23,2016-11-23,Utilities
40906174,0,16592,-18751653,2016-11-23,2016-11-23,
40906174,0,10677,-18740976,2016-11-23,2016-11-23,
40906174,0,740024,-18000952,2016-11-24,2016-11-24,
40906174,0,532803,-17468149,2016-11-24,2016-11-24,
40906174,0,858130,-16610019,2016-11-24,2016-11-24,
40906174,19253,0,-16629272,2016-11-25,2016-11-25,Groceries
40906174,0,889982,-15739290,2016-11-25,2016-11-25,
40906174,646162,0,-16385452,2016-11-26,2016-11-26,Clothes
40906174,0,868929,-15516523,2016-11-27,2016-11-27,
40906174,0,19949,-15496574,2016-11-27,2016-11-27,
40906174,13303,0,-15509877,2016-11-28,2016-11-28,Entertainment
40906174,0,561590,-14948287,2016-11-29,2016-11-29,
40906174,0,816860,-14131427,2016-11-30,2016-11-30,
40906174,582313,0,-14713740,2016-11-30,2016-11-30,Groceries
40906174,595813,0,-15309553,2016-11-30,2016-11-30,Clothes
40906174,986818,0,-16296371,2016-12-01,2016-12-01,Clothes
40906174,0,18428,-16277943,2016-12-01,2016-12-01,
40906174,0,830032,-15447911,2016-12-01,2016-12-01,
40906174,412933,0,-15860844,2016-12-02,2016-12-02,Transportation
40906174,18262,0,-15879106,2016-12-02,2016-12-02,Groceries
40906174,425019,0,-16304125,2016-12-02,2016-12-02,Clothes
40906174,756159,0,-17060284,2016-12-03,2016-12-03,Utilities
40906174,13599,0,-17073883,2016-12-04,2016-12-04,Groceries
40906174,0,418062,-16655821,2016-12-05,2016-12-05,
40906174,13182,0,-16669003,2016-12-05,2016-12-05,Transportation
40906174,0,868432,-15800571,2016-12-06,2016-12-06,
40906174,17405,0,-15817976,2016-12-07,2016-12-07,Education
40906174,797405,0,-16615381,2016-12-07,2016-12-07,Groceries
40906174,553055,0,-17168436,2016-12-07,2016-12-07,Education
40906174,10310,0,-17178746,2016-12-08,2016-12-08,Rent
40906174,0,13741,-17165005,2016-12-08,2016-12-08,
40906174,0,17059,-17147946,2016-12-08,2016-12-08,
40906174,0,672908,-16475038,2016-12-09,2016-12-09,
40906174,0,13158,-16461880,2016-12-10,2016-12-10,
40906174,841478,0,-17303358,2016-12-11,2016-12-11,Bill Sharing
40906174,0,15750,-17287608,2016-12-11,2016-12-11,
40906174,0,19271,-17268337,2016-12-12,2016-12-12,
40906174,0,16421,-17251916,2016-12-13,2016-12-13,
40906174,481679,0,-17733595,2016-12-13,2016-12-13,Healthcare
40906174,11693,0,-17745288,2016-12-14,2016-12-14,Rent
40906174,0,544546,-17200742,2016-12-14,2016-12-14,
40906174,688406,0,-17889148,2016-12-14,2016-12-14,Entertainment
40906174,0,717064,-17172084,2016-12-15,2016-12-15,
40906174,0,436560,-16735524,2016-12-15,2016-12-15,
40906174,413350,0,-17148874,2016-12-16,2016-12-16,Bill Sharing
40906174,0,966691,-16182183,2016-12-16,2016-12-16,
40906174,17388,0,-16199571,2016-12-17,2016-12-17,Clothes
40906174,0,742506,-15457065,2016-12-18,2016-12-18,
40906174,846549,0,-16303614,2016-12-18,2016-12-18,Transportation
40906174,816710,0,-17120324,2016-12-19,2016-12-19,Education
40906174,17020,0,-17137344,2016-12-19,2016-12-19,Clothes
40906174,0,600976,-16536368,2016-12-20,2016-12-20,
40906174,550191,0,-17086559,2016-12-21,2016-12-21,Utilities
40906174,548536,0,-17635095,2016-12-21,2016-12-21,Entertainment
40906174,0,804339,-16830756,2016-12-22,2016-12-22,
40906174,964330,0,-17795086,2016-12-22,2016-12-22,Groceries
40906174,519886,0,-18314972,2016-12-23,2016-12-23,Transportation
40906174,628181,0,-18943153,2016-12-24,2016-12-24,Education
40906174,0,743428,-18199725,2016-12-25,2016-12-25,
40906174,0,11229,-18188496,2016-12-25,2016-12-25,
40906174,0,19799,-18168697,2016-12-26,2016-12-26,
40906174,18762,0,-18187459,2016-12-26,2016-12-26,Education
40906174,0,617659,-17569800,2016-12-27,2016-12-27,
40906174,828663,0,-18398463,2016-12-28,2016-12-28,Groceries
40906174,603990,0,-19002453,2016-12-28,2016-12-28,Entertainment
40906174,17728,0,-19020181,2016-12-28,2016-12-28,Clothes
40906174,971607,0,-19991788,2016-12-29,2016-12-29,Transportation
40906174,0,563612,-19428176,2016-12-30,2016-12-30,
40906174,15459,0,-19443635,2016-12-30,2016-12-30,Healthcare
40906174,505665,0,-19949300,2016-12-30,2016-12-30,Groceries
40906174,437499,0,-20386799,2016-12-31,2016-12-31,Education
40906174,934775,0,-21321574,2017-01-01,2017-01-01,Transportation
40906174,0,14669,-21306905,2017-01-02,2017-01-02,
40906174,676183,0,-21287605,2017-01-02,2017-01-02,Healthcare
40906174,0,480946,-20806659,2017-01-03,2017-01-03,
40906174,0,11176,-20795483,2017-01-04,2017-01-04,
40906174,0,900974,-19894509,2017-01-05,2017-01-05,
40906174,0,755594,-19138915,2017-01-05,2017-01-05,
40906174,681629,0,-19820544,2017-01-05,2017-01-05,Entertainment
40906174,0,12781,-19807763,2017-01-06,2017-01-06,
40906174,0,697782,-19109981,2017-01-07,2017-01-07,
40906174,13866,0,-19123847,2017-01-07,2017-01-07,Utilities
40906174,0,750538,-18373309,2017-01-08,2017-01-08,
40906174,520216,0,-18893525,2017-01-08,2017-01-08,Transportation
40906174,0,761044,-18132481,2017-01-08,2017-01-08,
40906174,0,593631,-17538850,2017-01-09,2017-01-09,
40906174,409022,0,-17947872,2017-01-10,2017-01-10,Bill Sharing
40906174,629033,0,-18576905,2017-01-11,2017-01-11,Education
40906174,552203,0,-19129108,2017-01-11,2017-01-11,Entertainment
40906174,849283,0,-19978391,2017-01-11,2017-01-11,Bill Sharing
40906174,480578,0,-19995905,2017-01-12,2017-01-12,Education
40906174,0,661462,-19334443,2017-01-13,2017-01-13,
40906174,15330,0,-19349773,2017-01-13,2017-01-13,Bill Sharing
40906174,14983,0,-19364756,2017-01-14,2017-01-14,Entertainment
40906174,991933,0,-20356689,2017-01-15,2017-01-15,Entertainment
40906174,0,13955,-20342734,2017-01-15,2017-01-15,
40906174,12979,0,-20355713,2017-01-15,2017-01-15,Utilities
40906174,0,966086,-19389627,2017-01-16,2017-01-16,
40906174,0,484433,-18905194,2017-01-16,2017-01-16,
40906174,0,511411,-18393783,2017-01-17,2017-01-17,
40906174,0,517449,-17876334,2017-01-17,2017-01-17,
40906174,13705,0,-17890039,2017-01-18,2017-01-18,Healthcare
40906174,0,619369,-17270670,2017-01-18,2017-01-18,
40906174,0,420362,-16850308,2017-01-19,2017-01-19,
40906174,0,799168,-16051140,2017-01-20,2017-01-20,
40906174,0,661847,-15389293,2017-01-20,2017-01-20,
40906174,856491,0,-16245784,2017-01-20,2017-01-20,Transportation
40906174,879807,0,-17125591,2017-01-21,2017-01-21,Healthcare
40906174,0,572547,-16553044,2017-01-21,2017-01-21,
40906174,947643,0,-17500687,2017-01-22,2017-01-22,Transportation
40906174,0,14605,-17486082,2017-01-22,2017-01-22,
40906174,0,480541,-17005541,2017-01-22,2017-01-22,
40906174,0,784689,-16220852,2017-01-23,2017-01-23,
40906174,782973,0,-17003825,2017-01-23,2017-01-23,Clothes
40906174,990367,0,-17994192,2017-01-23,2017-01-23,Entertainment
40906174,835161,0,-18829353,2017-01-24,2017-01-24,Entertainment
40906174,19980,0,-18849333,2017-01-25,2017-01-25,Clothes
40906174,747982,0,-19597315,2017-01-25,2017-01-25,Rent
40906174,0,550056,-19047259,2017-01-26,2017-01-26,
40906174,0,930079,-18117180,2017-01-26,2017-01-26,
40906174,633913,0,-18131399,2017-01-27,2017-01-27,Healthcare
40906174,0,13789,-18117610,2017-01-27,2017-01-27,
40906174,0,15770,-18101840,2017-01-27,2017-01-27,
40906174,12490,0,-18114330,2017-01-28,2017-01-28,Groceries
40906174,592260,0,-18706590,2017-01-28,2017-01-28,Education
40906174,0,653244,-18053346,2017-01-29,2017-01-29,
40906174,0,451253,-18064324,2017-01-30,2017-01-30,
40906174,0,16575,-18047749,2017-01-30,2017-01-30,
40906174,10880,0,-18058629,2017-01-30,2017-01-30,Healthcare
40906174,0,15397,-18043232,2017-01-31,2017-01-31,
40906174,0,19236,-18023996,2017-01-31,2017-01-31,
40906174,403178,0,-18041712,2017-02-01,2017-02-01,Education
40906174,13060,0,-18054772,2017-02-01,2017-02-01,Groceries
40906174,958599,0,-19013371,2017-02-02,2017-02-02,Entertainment
40906174,16598,0,-19029969,2017-02-02,2017-02-02,Transportation
40906174,15877,0,-19045846,2017-02-02,2017-02-02,Healthcare
40906174,781667,0,-19827513,2017-02-03,2017-02-03,Rent
40906174,905209,0,-19814560,2017-02-03,2017-02-03,Healthcare
40906174,722511,0,-20537071,2017-02-03,2017-02-03,Rent
40906174,19000,0,-20556071,2017-02-04,2017-02-04,Clothes
40906174,0,637577,-19947279,2017-02-04,2017-02-04,
40906174,603659,0,-20550938,2017-02-05,2017-02-05,Bill Sharing
40906174,0,807326,-19743612,2017-02-06,2017-02-06,
40906174,0,468289,-19275323,2017-02-06,2017-02-06,
40906174,0,11712,-19263611,2017-02-07,2017-02-07,
40906174,789718,0,-20053329,2017-02-07,2017-02-07,Transportation
40906174,0,804672,-19248657,2017-02-07,2017-02-07,
40906174,0,15130,-19233527,2017-02-08,2017-02-08,
40906174,0,15760,-19217767,2017-02-09,2017-02-09,
40906174,0,13219,-19204548,2017-02-09,2017-02-09,
40906174,16586,0,-19221134,2017-02-09,2017-02-09,Transportation
40906174,0,12626,-19208508,2017-02-10,2017-02-10,
40906174,531146,0,-19739654,2017-02-10,2017-02-10,Utilities
40906174,10752,0,-19750406,2017-02-10,2017-02-10,Bill Sharing
40906174,857216,0,-20607622,2017-02-11,2017-02-11,Education
40906174,0,10897,-20596725,2017-02-11,2017-02-11,
40906174,951306,0,-21548031,2017-02-12,2017-02-12,Education
40906174,0,703118,-20844913,2017-02-12,2017-02-12,
40906174,0,11921,-20832992,2017-02-13,2017-02-13,
40906174,12126,0,-20845118,2017-02-13,2017-02-13,Clothes
40906174,0,19259,-20825859,2017-02-13,2017-02-13,
40906174,454533,0,-21280392,2017-02-14,2017-02-14,Groceries
40906174,0,600805,-20679587,2017-02-14,2017-02-14,
40906174,931563,0,-21611150,2017-02-15,2017-02-15,Clothes
40906174,19589,0,-21630739,2017-02-16,2017-02-16,Clothes
40906174,0,523293,-21107446,2017-02-17,2017-02-17,
40906174,0,13617,-21093829,2017-02-17,2017-02-17,
40906174,832337,0,-21926166,2017-02-17,2017-02-17,Transportation
40906174,0,602568,-21323598,2017-02-18,2017-02-18,
40906174,10924,0,-21334522,2017-02-19,2017-02-19,Clothes
40906174,17928,0,-21352450,2017-02-20,2017-02-20,Rent
40906174,0,17114,-21335336,2017-02-21,2017-02-21,
40906174,487659,0,-21822995,2017-02-22,2017-02-22,Bill Sharing
40906174,0,997047,-20825948,2017-02-23,2017-02-23,
40906174,12320,0,-20838268,2017-02-24,2017-02-24,Bill Sharing
40906174,10797,0,-20849065,2017-02-24,2017-02-24,Rent
40906174,0,633941,-20215124,2017-02-24,2017-02-24,
40906174,16691,0,-20231815,2017-02-25,2017-02-25,Clothes
40906174,19103,0,-20250918,2017-02-25,2017-02-25,Groceries
40906174,0,12317,-20238601,2017-02-26,2017-02-26,
40906174,0,531732,-19706869,2017-02-27,2017-02-27,
40906174,16361,0,-19723230,2017-02-27,2017-02-27,Education
40906174,0,19082,-19704148,2017-02-28,2017-02-28,
40906174,19236,0,-19723384,2017-02-28,2017-02-28,Clothes
40906174,705155,0,-20428539,2017-02-28,2017-02-28,Utilities
40906174,741290,0,-21169829,2017-03-01,2017-03-01,Rent
40906174,930510,0,-21575886,2017-03-01,2017-03-01,Healthcare
40906174,457543,0,-22033429,2017-03-02,2017-03-02,Rent
40906174,0,13976,-22019453,2017-03-02,2017-03-02,
40906174,0,12221,-22007232,2017-03-02,2017-03-02,
40906174,0,968081,-21039151,2017-03-03,2017-03-03,
40906174,795592,0,-21834743,2017-03-03,2017-03-03,Rent
40906174,10168,0,-21844911,2017-03-04,2017-03-04,Utilities
40906174,0,18004,-21826907,2017-03-04,2017-03-04,
40906174,0,922011,-20904896,2017-03-04,2017-03-04,
40906174,652687,0,-21557583,2017-03-05,2017-03-05,Clothes
40906174,18811,0,-21576394,2017-03-05,2017-03-05,Clothes
40906174,0,638147,-20938247,2017-03-06,2017-03-06,
40906174,18789,0,-20957036,2017-03-06,2017-03-06,Rent
40906174,806475,0,-21763511,2017-03-07,2017-03-07,Education
40906174,0,12842,-21750669,2017-03-08,2017-03-08,
40906174,13150,0,-21763819,2017-03-09,2017-03-09,Entertainment
40906174,0,580092,-21183727,2017-03-09,2017-03-09,
40906174,18613,0,-21202340,2017-03-09,2017-03-09,Transportation
40906174,13790,0,-21216130,2017-03-10,2017-03-10,Clothes
40906174,0,15752,-21200378,2017-03-10,2017-03-10,
40906174,0,967848,-20232530,2017-03-10,2017-03-10,
40906174,787641,0,-21020171,2017-03-11,2017-03-11,Healthcare
40906174,0,986941,-20033230,2017-03-11,2017-03-11,
40906174,0,15058,-20018172,2017-03-12,2017-03-12,
40906174,13878,0,-20032050,2017-03-12,2017-03-12,Education
40906174,558841,0,-20017748,2017-03-12,2017-03-12,Healthcare
40906174,727236,0,-19127255,2017-03-13,2017-03-13,Healthcare
40906174,0,16369,-19110886,2017-03-13,2017-03-13,
40906174,530839,0,-19641725,2017-03-14,2017-03-14,Bill Sharing
40906174,675355,0,-20317080,2017-03-15,2017-03-15,Bill Sharing
40906174,0,817302,-19499778,2017-03-16,2017-03-16,
40906174,913198,0,-20412976,2017-03-17,2017-03-17,Healthcare
40906174,19553,0,-20432529,2017-03-17,2017-03-17,Entertainment
40906174,15545,0,-20448074,2017-03-18,2017-03-18,Healthcare
40906174,954557,0,-21402631,2017-03-19,2017-03-19,Bill Sharing
40906174,14803,0,-21417434,2017-03-19,2017-03-19,Groceries
40906174,812727,0,-22230161,2017-03-19,2017-03-19,Rent
40906174,0,414240,-21815921,2017-03-20,2017-03-20,
40906174,0,10791,-21805130,2017-03-20,2017-03-20,
40906174,0,17938,-21787192,2017-03-21,2017-03-21,
40906174,0,516973,-21270219,2017-03-21,2017-03-21,
40906174,0,12911,-21257308,2017-03-22,2017-03-22,
40906174,409549,0,-21666857,2017-03-23,2017-03-23,Transportation
40906174,565465,0,-22232322,2017-03-24,2017-03-24,Entertainment
40906174,0,14582,-22217740,2017-03-24,2017-03-24,
40906174,0,18928,-22198812,2017-03-24,2017-03-24,
40906174,772824,0,-22971636,2017-03-25,2017-03-25,Rent
40906174,918860,0,-22956234,2017-03-26,2017-03-26,Healthcare
40906174,454345,0,-23410579,2017-03-27,2017-03-27,Entertainment
40906174,16479,0,-23427058,2017-03-27,2017-03-27,Groceries
40906174,985761,0,-24412819,2017-03-27,2017-03-27,Rent
40906174,611186,0,-25024005,2017-03-28,2017-03-28,Bill Sharing
40906174,0,17755,-25006250,2017-03-28,2017-03-28,
40906174,10044,0,-25016294,2017-03-28,2017-03-28,Bill Sharing
40906174,19211,0,-25035505,2017-03-29,2017-03-29,Rent
40906174,0,15841,-25019664,2017-03-30,2017-03-30,
40906174,780744,0,-25800408,2017-03-30,2017-03-30,Entertainment
40906174,19124,0,-25819532,2017-03-31,2017-03-31,Education
40906174,768632,0,-26588164,2017-04-01,2017-04-01,Rent
40906174,0,702098,-25886066,2017-04-01,2017-04-01,
40906174,0,13225,-25872841,2017-04-01,2017-04-01,
40906174,856466,0,-26729307,2017-04-02,2017-04-02,Entertainment
40906174,19874,0,-26749181,2017-04-03,2017-04-03,Entertainment
40906174,876202,0,-27625383,2017-04-03,2017-04-03,Rent
40906174,0,729464,-26895919,2017-04-03,2017-04-03,
40906174,0,17910,-26878009,2017-04-04,2017-04-04,
40906174,0,10710,-26867299,2017-04-04,2017-04-04,
40906174,0,689456,-26177843,2017-04-04,2017-04-04,
40906174,19423,0,-26197266,2017-04-05,2017-04-05,Bill Sharing
40906174,0,609824,-25587442,2017-04-05,2017-04-05,
40906174,788101,0,-26375543,2017-04-05,2017-04-05,Clothes
40906174,0,928362,-25447181,2017-04-06,2017-04-06,
40906174,927115,0,-26374296,2017-04-07,2017-04-07,Education
40906174,10311,0,-26384607,2017-04-07,2017-04-07,Bill Sharing
40906174,0,968967,-25415640,2017-04-08,2017-04-08,
40906174,629710,0,-26045350,2017-04-08,2017-04-08,Education
40906174,0,578985,-25466365,2017-04-08,2017-04-08,
40906174,816815,0,-26283180,2017-04-09,2017-04-09,Rent
40906174,0,16163,-26267017,2017-04-09,2017-04-09,
40906174,784240,0,-27051257,2017-04-10,2017-04-10,Entertainment
40906174,0,580103,-26471154,2017-04-11,2017-04-11,
40906174,0,17070,-26454084,2017-04-11,2017-04-11,
40906174,19086,0,-26473170,2017-04-12,2017-04-12,Rent
40906174,0,17623,-26455547,2017-04-12,2017-04-12,
40906174,0,492988,-25962559,2017-04-13,2017-04-13,
40906174,746073,0,-26708632,2017-04-13,2017-04-13,Utilities
40906174,0,17537,-26691095,2017-04-13,2017-04-13,
40906174,870574,0,-27561669,2017-04-14,2017-04-14,Transportation
40906174,0,676198,-26885471,2017-04-14,2017-04-14,
40906174,825538,0,-27711009,2017-04-14,2017-04-14,Entertainment
40906174,0,425882,-27285127,2017-04-15,2017-04-15,
40906174,13809,0,-27298936,2017-04-15,2017-04-15,Entertainment
40906174,649836,0,-27948772,2017-04-16,2017-04-16,Bill Sharing
40906174,0,562679,-27386093,2017-04-16,2017-04-16,
40906174,0,13223,-27372870,2017-04-16,2017-04-16,
40906174,894638,0,-28267508,2017-04-17,2017-04-17,Entertainment
40906174,855786,0,-29123294,2017-04-18,2017-04-18,Healthcare
40906174,0,15331,-29107963,2017-04-19,2017-04-19,
40906174,0,604114,-28503849,2017-04-20,2017-04-20,
40906174,897950,0,-29401799,2017-04-21,2017-04-21,Utilities
40906174,0,13305,-29388494,2017-04-22,2017-04-22,
40906174,667244,0,-30055738,2017-04-23,2017-04-23,Groceries
40906174,0,14893,-30040845,2017-04-23,2017-04-23,
40906174,0,13881,-30026964,2017-04-23,2017-04-23,
40906174,0,579287,-29447677,2017-04-24,2017-04-24,
40906174,0,762431,-29431106,2017-04-25,2017-04-25,
40906174,11957,0,-29443063,2017-04-25,2017-04-25,Clothes
40906174,0,712036,-28731027,2017-04-26,2017-04-26,
40906174,0,495902,-28235125,2017-04-26,2017-04-26,
40906174,0,426303,-27808822,2017-04-27,2017-04-27,
40906174,0,17094,-27791728,2017-04-27,2017-04-27,
40906174,0,487471,-26986237,2017-04-27,2017-04-27,
40906174,683085,0,-27669322,2017-04-28,2017-04-28,Clothes
40906174,0,789146,-26880176,2017-04-28,2017-04-28,
40906174,0,792236,-26447012,2017-04-29,2017-04-29,
40906174,708301,0,-27155313,2017-04-30,2017-04-30,Entertainment
40906174,0,880813,-26274500,2017-04-30,2017-04-30,
40906174,781863,0,-27056363,2017-05-01,2017-05-01,Education
40906174,0,18303,-27038060,2017-05-01,2017-05-01,
40906174,0,837768,-26200292,2017-05-02,2017-05-02,
40906174,0,860740,-25339552,2017-05-03,2017-05-03,
40906174,603886,0,-25943438,2017-05-03,2017-05-03,Transportation
40906174,0,437029,-25506409,2017-05-04,2017-05-04,
40906174,0,520473,-24985936,2017-05-05,2017-05-05,
40906174,15445,0,-25001381,2017-05-05,2017-05-05,Rent
40906174,0,533381,-24468000,2017-05-05,2017-05-05,
40906174,0,928033,-23539967,2017-05-06,2017-05-06,
40906174,926615,0,-24466582,2017-05-07,2017-05-07,Healthcare
40906174,12307,0,-24478889,2017-05-07,2017-05-07,Entertainment
40906174,0,548488,-23930401,2017-05-08,2017-05-08,
40906174,0,17395,-23913006,2017-05-08,2017-05-08,
40906174,417329,0,-24330335,2017-05-09,2017-05-09,Bill Sharing
40906174,11488,0,-24341823,2017-05-09,2017-05-09,Transportation
40906174,426837,0,-24768660,2017-05-09,2017-05-09,Bill Sharing
40906174,0,806398,-24256245,2017-05-10,2017-05-10,
40906174,0,19420,-24236825,2017-05-10,2017-05-10,
40906174,0,18689,-24218136,2017-05-10,2017-05-10,
40906174,0,10360,-24207776,2017-05-11,2017-05-11,
40906174,697598,0,-24905374,2017-05-12,2017-05-12,Utilities
40906174,0,451887,-24453487,2017-05-12,2017-05-12,
40906174,0,670766,-23782721,2017-05-13,2017-05-13,
40906174,0,12622,-23770099,2017-05-14,2017-05-14,
40906174,0,581588,-23188511,2017-05-14,2017-05-14,
40906174,791085,0,-23979596,2017-05-14,2017-05-14,Bill Sharing
40906174,14273,0,-23993869,2017-05-15,2017-05-15,Education
40906174,17795,0,-24011664,2017-05-16,2017-05-16,Bill Sharing
40906174,913982,0,-24925646,2017-05-16,2017-05-16,Rent
40906174,606105,0,-25531751,2017-05-17,2017-05-17,Healthcare
40906174,15831,0,-25547582,2017-05-17,2017-05-17,Education
40906174,0,638825,-24908757,2017-05-17,2017-05-17,
40906174,872389,0,-25781146,2017-05-18,2017-05-18,Transportation
40906174,0,14893,-25766253,2017-05-18,2017-05-18,
40906174,0,645723,-25120530,2017-05-18,2017-05-18,
40906174,0,899183,-24221347,2017-05-19,2017-05-19,
40906174,0,11546,-24209801,2017-05-20,2017-05-20,
40906174,0,941883,-23267918,2017-05-20,2017-05-20,
40906174,926536,0,-24194454,2017-05-21,2017-05-21,Healthcare
40906174,0,14418,-24180036,2017-05-21,2017-05-21,
40906174,0,894582,-23285454,2017-05-21,2017-05-21,
40906174,0,692157,-22593297,2017-05-22,2017-05-22,
40906174,462191,0,-23055488,2017-05-22,2017-05-22,Education
40906174,0,589039,-22466449,2017-05-22,2017-05-22,
40906174,0,851548,-21614901,2017-05-23,2017-05-23,
40906174,0,14064,-21600837,2017-05-23,2017-05-23,
40906174,979153,0,-22579990,2017-05-24,2017-05-24,Utilities
40906174,638167,0,-23218157,2017-05-24,2017-05-24,Entertainment
40906174,0,12229,-23205928,2017-05-24,2017-05-24,
40906174,846355,0,-24052283,2017-05-25,2017-05-25,Education
40906174,0,444901,-23607382,2017-05-26,2017-05-26,
40906174,0,920275,-22687107,2017-05-27,2017-05-27,
40906174,0,685243,-22001864,2017-05-27,2017-05-27,
40906174,0,947674,-21054190,2017-05-28,2017-05-28,
40906174,16502,0,-21070692,2017-05-28,2017-05-28,Groceries
40906174,19594,0,-21090286,2017-05-29,2017-05-29,Utilities
40906174,0,531582,-20558704,2017-05-29,2017-05-29,
40906174,16069,0,-20574773,2017-05-30,2017-05-30,Bill Sharing
40906174,0,918220,-19656553,2017-05-31,2017-05-31,
40906174,598824,0,-20255377,2017-06-01,2017-06-01,Healthcare
40906174,0,11409,-20243968,2017-06-02,2017-06-02,
40906174,15119,0,-20259087,2017-06-02,2017-06-02,Healthcare
40906174,0,492848,-19766239,2017-06-02,2017-06-02,
40906174,927348,0,-20693587,2017-06-03,2017-06-03,Transportation
40906174,10554,0,-20704141,2017-06-03,2017-06-03,Rent
40906174,749923,0,-21454064,2017-06-04,2017-06-04,Clothes
40906174,0,15392,-21438672,2017-06-04,2017-06-04,
40906174,0,711021,-20727651,2017-06-04,2017-06-04,
40906174,19257,0,-20746908,2017-06-05,2017-06-05,Rent
40906174,695889,0,-21442797,2017-06-05,2017-06-05,Transportation
40906174,447854,0,-21890651,2017-06-05,2017-06-05,Bill Sharing
40906174,12686,0,-21903337,2017-06-06,2017-06-06,Education
40906174,13160,0,-21916497,2017-06-06,2017-06-06,Transportation
40906174,0,16414,-21900083,2017-06-06,2017-06-06,
40906174,994969,0,-22895052,2017-06-07,2017-06-07,Clothes
40906174,16834,0,-22911886,2017-06-07,2017-06-07,Transportation
40906174,10317,0,-22922203,2017-06-07,2017-06-07,Bill Sharing
40906174,691044,0,-23613247,2017-06-08,2017-06-08,Education
40906174,10263,0,-23623510,2017-06-08,2017-06-08,Utilities
40906174,0,437772,-23185738,2017-06-08,2017-06-08,
40906174,0,13822,-23171916,2017-06-09,2017-06-09,
40906174,13611,0,-23185527,2017-06-09,2017-06-09,Healthcare
40906174,472764,0,-23658291,2017-06-10,2017-06-10,Bill Sharing
40906174,889412,0,-24547703,2017-06-11,2017-06-11,Healthcare
40906174,0,16441,-24531262,2017-06-11,2017-06-11,
40906174,0,901991,-23629271,2017-06-11,2017-06-11,
40906174,0,542946,-23086325,2017-06-12,2017-06-12,
40906174,0,568100,-22518225,2017-06-13,2017-06-13,
40906174,0,17424,-22500801,2017-06-14,2017-06-14,
40906174,15140,0,-22515941,2017-06-14,2017-06-14,Groceries
40906174,13247,0,-22529188,2017-06-15,2017-06-15,Education
40906174,0,18895,-22510293,2017-06-15,2017-06-15,
40906174,748889,0,-23142039,2017-06-15,2017-06-15,Education
40906174,0,12835,-23129204,2017-06-16,2017-06-16,
40906174,652622,0,-23781826,2017-06-16,2017-06-16,Bill Sharing
40906174,12387,0,-23794213,2017-06-17,2017-06-17,Clothes
40906174,0,695946,-23098267,2017-06-17,2017-06-17,
40906174,0,925501,-22172766,2017-06-18,2017-06-18,
40906174,0,506867,-21665899,2017-06-18,2017-06-18,
40906174,0,935026,-20730873,2017-06-19,2017-06-19,
40906174,0,444035,-20286838,2017-06-20,2017-06-20,
40906174,13691,0,-20300529,2017-06-21,2017-06-21,Clothes
40906174,0,13754,-20286775,2017-06-21,2017-06-21,
40906174,685439,0,-20972214,2017-06-22,2017-06-22,Bill Sharing
40906174,0,18994,-20953220,2017-06-22,2017-06-22,
40906174,0,628685,-20324535,2017-06-23,2017-06-23,
40906174,504741,0,-20829276,2017-06-23,2017-06-23,Entertainment
40906174,0,983625,-20816822,2017-06-24,2017-06-24,
40906174,0,15527,-20801295,2017-06-24,2017-06-24,
40906174,0,17690,-20783605,2017-06-25,2017-06-25,
40906174,912905,0,-21696510,2017-06-25,2017-06-25,Education
40906174,616356,0,-22312866,2017-06-25,2017-06-25,Utilities
40906174,996881,0,-23309747,2017-06-26,2017-06-26,Clothes
40906174,0,735785,-22573962,2017-06-26,2017-06-26,
40906174,0,12440,-22561522,2017-06-26,2017-06-26,
40906174,952725,0,-23514247,2017-06-27,2017-06-27,Bill Sharing
40906174,842099,0,-24356346,2017-06-27,2017-06-27,Clothes
40906174,673227,0,-25029573,2017-06-28,2017-06-28,Entertainment
40906174,14016,0,-25043589,2017-06-28,2017-06-28,Bill Sharing
40906174,0,18466,-25025123,2017-06-28,2017-06-28,
40906174,0,18113,-25007010,2017-06-29,2017-06-29,
40906174,988094,0,-25995104,2017-06-30,2017-06-30,Bill Sharing
40906174,0,622853,-25372251,2017-07-01,2017-07-01,
40906174,487656,0,-25859907,2017-07-02,2017-07-02,Entertainment
40906174,0,15077,-25844830,2017-07-02,2017-07-02,
40906174,689029,0,-26533859,2017-07-03,2017-07-03,Rent
40906174,485967,0,-27019826,2017-07-03,2017-07-03,Rent
40906174,0,19020,-27000806,2017-07-04,2017-07-04,
40906174,0,560049,-26440757,2017-07-04,2017-07-04,
40906174,0,17887,-26422870,2017-07-04,2017-07-04,
40906174,730244,0,-27153114,2017-07-05,2017-07-05,Rent
40906174,0,19588,-27133526,2017-07-05,2017-07-05,
40906174,0,923719,-26209807,2017-07-05,2017-07-05,
40906174,983546,0,-27193353,2017-07-06,2017-07-06,Utilities
40906174,0,981273,-26212080,2017-07-06,2017-07-06,
40906174,717608,0,-26929688,2017-07-06,2017-07-06,Bill Sharing
40906174,18661,0,-26948349,2017-07-07,2017-07-07,Education
40906174,683474,0,-27631823,2017-07-07,2017-07-07,Healthcare
40906174,14679,0,-27646502,2017-07-08,2017-07-08,Transportation
40906174,0,819347,-26827155,2017-07-08,2017-07-08,
40906174,0,19265,-26807890,2017-07-09,2017-07-09,
40906174,979735,0,-27787625,2017-07-09,2017-07-09,Education
40906174,0,17771,-27769854,2017-07-10,2017-07-10,
40906174,0,11109,-27758745,2017-07-10,2017-07-10,
40906174,0,479071,-27279674,2017-07-10,2017-07-10,
40906174,0,11416,-27268258,2017-07-11,2017-07-11,
40906174,0,673225,-26595033,2017-07-11,2017-07-11,
40906174,817403,0,-27412436,2017-07-12,2017-07-12,Rent
40906174,0,12605,-27399831,2017-07-12,2017-07-12,
40906174,0,13981,-27385850,2017-07-13,2017-07-13,
40906174,15761,0,-27401611,2017-07-13,2017-07-13,Bill Sharing
40906174,0,791705,-26609906,2017-07-13,2017-07-13,
40906174,14565,0,-26624471,2017-07-14,2017-07-14,Utilities
40906174,0,847174,-25777297,2017-07-15,2017-07-15,
40906174,0,954046,-24823251,2017-07-15,2017-07-15,
40906174,14950,0,-24838201,2017-07-16,2017-07-16,Healthcare
40906174,19274,0,-24857475,2017-07-17,2017-07-17,Clothes
40906174,14538,0,-24872013,2017-07-17,2017-07-17,Transportation
40906174,926901,0,-25798914,2017-07-17,2017-07-17,Groceries
40906174,0,662399,-25136515,2017-07-18,2017-07-18,
40906174,15207,0,-25151722,2017-07-19,2017-07-19,Education
40906174,11087,0,-25162809,2017-07-20,2017-07-20,Healthcare
40906174,0,12440,-25150369,2017-07-20,2017-07-20,
40906174,0,468597,-24681772,2017-07-21,2017-07-21,
40906174,938203,0,-25619975,2017-07-22,2017-07-22,Healthcare
40906174,0,13191,-25606784,2017-07-22,2017-07-22,
40906174,0,13550,-25593234,2017-07-23,2017-07-23,
40906174,0,840698,-24752536,2017-07-23,2017-07-23,
40906174,0,522944,-24229592,2017-07-23,2017-07-23,
40906174,0,527885,-23701707,2017-07-24,2017-07-24,
40906174,0,785785,-22915922,2017-07-24,2017-07-24,
40906174,18630,0,-22934552,2017-07-24,2017-07-24,Groceries
40906174,0,13657,-22920895,2017-07-25,2017-07-25,
40906174,0,970404,-21950491,2017-07-26,2017-07-26,
40906174,0,669700,-21280791,2017-07-26,2017-07-26,
40906174,19126,0,-21299917,2017-07-27,2017-07-27,Entertainment
40906174,697047,0,-21996964,2017-07-27,2017-07-27,Groceries
40906174,938289,0,-22935253,2017-07-27,2017-07-27,Groceries
40906174,0,692925,-22242328,2017-07-28,2017-07-28,
40906174,408874,0,-22651202,2017-07-29,2017-07-29,Transportation
40906174,15066,0,-22666268,2017-07-30,2017-07-30,Education
40906174,0,16946,-22649322,2017-07-30,2017-07-30,
40906174,0,715034,-21934288,2017-07-31,2017-07-31,
40906174,0,619730,-21314558,2017-08-01,2017-08-01,
40906174,0,592697,-20721861,2017-08-01,2017-08-01,
40906174,13900,0,-20735761,2017-08-01,2017-08-01,Healthcare
40906174,498480,0,-21234241,2017-08-02,2017-08-02,Entertainment
40906174,17916,0,-21252157,2017-08-02,2017-08-02,Utilities
40906174,795732,0,-22047889,2017-08-03,2017-08-03,Utilities
40906174,660765,0,-22708654,2017-08-03,2017-08-03,Rent
40906174,0,751861,-21956793,2017-08-03,2017-08-03,
40906174,0,738330,-21218463,2017-08-04,2017-08-04,
40906174,860703,0,-22079166,2017-08-05,2017-08-05,Entertainment
40906174,452354,0,-22531520,2017-08-06,2017-08-06,Entertainment
40906174,427565,0,-22959085,2017-08-06,2017-08-06,Clothes
40906174,751846,0,-23710931,2017-08-07,2017-08-07,Transportation
40906174,0,12405,-23698526,2017-08-07,2017-08-07,
40906174,827817,0,-24526343,2017-08-08,2017-08-08,Groceries
40906174,501365,0,-25027708,2017-08-08,2017-08-08,Utilities
40906174,18374,0,-25046082,2017-08-09,2017-08-09,Rent
40906174,562303,0,-25608385,2017-08-09,2017-08-09,Healthcare
40906174,944080,0,-26552465,2017-08-10,2017-08-10,Entertainment
40906174,16798,0,-26569263,2017-08-11,2017-08-11,Utilities
40906174,0,494551,-26074712,2017-08-11,2017-08-11,
40906174,0,926316,-25148396,2017-08-11,2017-08-11,
40906174,0,826469,-24321927,2017-08-12,2017-08-12,
40906174,883159,0,-25205086,2017-08-13,2017-08-13,Transportation
40906174,726632,0,-25931718,2017-08-13,2017-08-13,Groceries
40906174,805191,0,-26736909,2017-08-13,2017-08-13,Clothes
40906174,0,721801,-26015108,2017-08-14,2017-08-14,
40906174,0,484069,-25531039,2017-08-14,2017-08-14,
40906174,0,478040,-25052999,2017-08-14,2017-08-14,
40906174,0,735890,-24317109,2017-08-15,2017-08-15,
40906174,0,503853,-23813256,2017-08-15,2017-08-15,
40906174,501995,0,-24694577,2017-08-15,2017-08-15,Healthcare
40906174,0,12425,-24682152,2017-08-16,2017-08-16,
40906174,0,608613,-24073539,2017-08-17,2017-08-17,
40906174,0,931832,-23141707,2017-08-17,2017-08-17,
40906174,810880,0,-23952587,2017-08-18,2017-08-18,Healthcare
40906174,531478,0,-24484065,2017-08-18,2017-08-18,Utilities
40906174,0,491923,-23992142,2017-08-19,2017-08-19,
40906174,583635,0,-24575777,2017-08-20,2017-08-20,Bill Sharing
40906174,0,437392,-24138385,2017-08-20,2017-08-20,
40906174,0,17446,-24120939,2017-08-20,2017-08-20,
40906174,0,970861,-23150078,2017-08-21,2017-08-21,
40906174,0,421199,-22728879,2017-08-22,2017-08-22,
40906174,17446,0,-22746325,2017-08-23,2017-08-23,Rent
40906174,0,19056,-22727269,2017-08-24,2017-08-24,
40906174,875563,0,-23602832,2017-08-24,2017-08-24,Education
40906174,962628,0,-24565460,2017-08-25,2017-08-25,Clothes
40906174,13930,0,-24579390,2017-08-26,2017-08-26,Healthcare
40906174,13587,0,-24592977,2017-08-26,2017-08-26,Entertainment
40906174,989662,0,-25582639,2017-08-26,2017-08-26,Rent
40906174,13207,0,-25595846,2017-08-27,2017-08-27,Clothes
40906174,0,13017,-25582829,2017-08-27,2017-08-27,
40906174,789051,0,-26371880,2017-08-28,2017-08-28,Bill Sharing
40906174,0,672011,-25551959,2017-08-28,2017-08-28,
40906174,0,613977,-24937982,2017-08-29,2017-08-29,
40906174,12965,0,-24950947,2017-08-30,2017-08-30,Rent
40906174,614717,0,-25565664,2017-08-30,2017-08-30,Groceries
40906174,10489,0,-25576153,2017-08-30,2017-08-30,Bill Sharing
40906174,0,684268,-24891885,2017-08-31,2017-08-31,
40906174,0,532520,-24359365,2017-08-31,2017-08-31,
40906174,0,502686,-23856679,2017-08-31,2017-08-31,
40906174,0,488922,-23367757,2017-09-01,2017-09-01,
40906174,17758,0,-23385515,2017-09-01,2017-09-01,Clothes
40906174,951375,0,-24336890,2017-09-02,2017-09-02,Transportation
40906174,0,18644,-24318246,2017-09-02,2017-09-02,
40906174,471521,0,-24789767,2017-09-03,2017-09-03,Healthcare
40906174,19312,0,-24809079,2017-09-03,2017-09-03,Clothes
40906174,0,621367,-24187712,2017-09-04,2017-09-04,
40906174,716461,0,-24904173,2017-09-04,2017-09-04,Groceries
40906174,16436,0,-24920609,2017-09-04,2017-09-04,Rent
40906174,513525,0,-25434134,2017-09-05,2017-09-05,Transportation
40906174,0,837781,-24596353,2017-09-06,2017-09-06,
40906174,429224,0,-24610605,2017-09-06,2017-09-06,Education
40906174,14421,0,-24625026,2017-09-06,2017-09-06,Utilities
40906174,0,827004,-23798022,2017-09-07,2017-09-07,
40906174,537056,0,-24335078,2017-09-07,2017-09-07,Rent
40906174,0,667080,-25287913,2017-09-08,2017-09-08,
40906174,0,10672,-25277241,2017-09-08,2017-09-08,
40906174,440176,0,-25717417,2017-09-09,2017-09-09,Education
40906174,669481,0,-26386898,2017-09-09,2017-09-09,Utilities
40906174,15556,0,-26402454,2017-09-09,2017-09-09,Education
40906174,464833,0,-26867287,2017-09-10,2017-09-10,Rent
40906174,0,15391,-26851896,2017-09-11,2017-09-11,
40906174,17038,0,-26868934,2017-09-12,2017-09-12,Groceries
40906174,794246,0,-27663180,2017-09-12,2017-09-12,Entertainment
40906174,780566,0,-28443746,2017-09-12,2017-09-12,Groceries
40906174,0,863339,-27580407,2017-09-13,2017-09-13,
40906174,800657,0,-28381064,2017-09-13,2017-09-13,Rent
40906174,0,849840,-27531224,2017-09-14,2017-09-14,
40906174,0,985148,-27549662,2017-09-15,2017-09-15,
40906174,763083,0,-28312745,2017-09-16,2017-09-16,Utilities
40906174,0,12896,-28299849,2017-09-16,2017-09-16,
40906174,15275,0,-28315124,2017-09-16,2017-09-16,Rent
40906174,0,719079,-27596045,2017-09-17,2017-09-17,
40906174,0,889108,-26706937,2017-09-18,2017-09-18,
40906174,0,17160,-26689777,2017-09-18,2017-09-18,
40906174,0,15543,-26674234,2017-09-19,2017-09-19,
40906174,449223,0,-26686342,2017-09-20,2017-09-20,Education
40906174,0,452649,-26233693,2017-09-21,2017-09-21,
40906174,0,14897,-26218796,2017-09-21,2017-09-21,
40906174,0,15444,-26203352,2017-09-22,2017-09-22,
40906174,961848,0,-27165200,2017-09-23,2017-09-23,Utilities
40906174,646860,0,-26192398,2017-09-23,2017-09-23,Education
40906174,605553,0,-25242332,2017-09-24,2017-09-24,Education
40906174,0,15409,-25226923,2017-09-24,2017-09-24,
40906174,13526,0,-25240449,2017-09-24,2017-09-24,Healthcare
40906174,0,13823,-25226626,2017-09-25,2017-09-25,
40906174,475163,0,-25701789,2017-09-25,2017-09-25,Entertainment
40906174,17515,0,-25719304,2017-09-26,2017-09-26,Utilities
40906174,0,778526,-24940778,2017-09-27,2017-09-27,
40906174,0,787902,-24152876,2017-09-27,2017-09-27,
40906174,19491,0,-24172367,2017-09-27,2017-09-27,Clothes
40906174,0,778431,-23393936,2017-09-28,2017-09-28,
40906174,0,19799,-23374137,2017-09-29,2017-09-29,
40906174,676471,0,-24050608,2017-09-29,2017-09-29,Entertainment
40906174,733539,0,-24784147,2017-09-30,2017-09-30,Entertainment
40906174,0,10901,-24773246,2017-09-30,2017-09-30,
40906174,0,527024,-24246222,2017-10-01,2017-10-01,
40906174,0,746570,-23499652,2017-10-01,2017-10-01,
40906174,0,568055,-22931597,2017-10-01,2017-10-01,
40906174,0,962533,-21969064,2017-10-02,2017-10-02,
40906174,435945,0,-22405009,2017-10-02,2017-10-02,Healthcare
40906174,0,14157,-22390852,2017-10-03,2017-10-03,
40906174,0,933063,-21457789,2017-10-03,2017-10-03,
40906174,0,19367,-21438422,2017-10-04,2017-10-04,
40906174,0,512484,-20925938,2017-10-05,2017-10-05,
40906174,710446,0,-21636384,2017-10-06,2017-10-06,Rent
40906174,0,449885,-21186499,2017-10-07,2017-10-07,
40906174,967549,0,-22154048,2017-10-07,2017-10-07,Education
40906174,0,14968,-22139080,2017-10-08,2017-10-08,
40906174,954988,0,-23094068,2017-10-08,2017-10-08,Bill Sharing
40906174,527786,0,-23621854,2017-10-08,2017-10-08,Transportation
40906174,749147,0,-24371001,2017-10-09,2017-10-09,Transportation
40906174,780811,0,-25151812,2017-10-09,2017-10-09,Healthcare
40906174,18090,0,-25169902,2017-10-09,2017-10-09,Entertainment
40906174,16012,0,-25185914,2017-10-10,2017-10-10,Education
40906174,0,17309,-25168605,2017-10-11,2017-10-11,
40906174,18325,0,-25186930,2017-10-11,2017-10-11,Rent
40906174,0,19886,-25167044,2017-10-11,2017-10-11,
40906174,580880,0,-25747924,2017-10-12,2017-10-12,Entertainment
40906174,860344,0,-26608268,2017-10-12,2017-10-12,Healthcare
40906174,885700,0,-27493968,2017-10-12,2017-10-12,Utilities
40906174,0,16717,-27477251,2017-10-13,2017-10-13,
40906174,10362,0,-27487613,2017-10-13,2017-10-13,Utilities
40906174,0,10482,-27477131,2017-10-14,2017-10-14,
40906174,14762,0,-27491893,2017-10-14,2017-10-14,Healthcare
40906174,18632,0,-27510525,2017-10-14,2017-10-14,Transportation
40906174,0,908055,-26602470,2017-10-15,2017-10-15,
40906174,15247,0,-26617717,2017-10-15,2017-10-15,Transportation
40906174,715148,0,-27332865,2017-10-15,2017-10-15,Education
40906174,15921,0,-27348786,2017-10-16,2017-10-16,Rent
40906174,0,12140,-27336646,2017-10-16,2017-10-16,
40906174,0,403242,-26933404,2017-10-16,2017-10-16,
40906174,12507,0,-26945911,2017-10-17,2017-10-17,Groceries
40906174,15836,0,-26961747,2017-10-18,2017-10-18,Bill Sharing
40906174,0,790739,-26171008,2017-10-19,2017-10-19,
40906174,18274,0,-26189282,2017-10-19,2017-10-19,Rent
40906174,912314,0,-27101596,2017-10-20,2017-10-20,Entertainment
40906174,0,443318,-26658278,2017-10-21,2017-10-21,
40906174,12710,0,-26670988,2017-10-21,2017-10-21,Transportation
40906174,15510,0,-26686498,2017-10-22,2017-10-22,Entertainment
40906174,0,13352,-26673146,2017-10-22,2017-10-22,
40906174,468713,0,-27141859,2017-10-23,2017-10-23,Education
40906174,0,544700,-26597159,2017-10-23,2017-10-23,
40906174,517983,0,-27115142,2017-10-24,2017-10-24,Education
40906174,665003,0,-27780145,2017-10-25,2017-10-25,Healthcare
40906174,624535,0,-28404680,2017-10-25,2017-10-25,Education
40906174,0,998004,-27406676,2017-10-25,2017-10-25,
40906174,0,17042,-27389634,2017-10-26,2017-10-26,
40906174,0,15320,-27374314,2017-10-26,2017-10-26,
40906174,598062,0,-27972376,2017-10-27,2017-10-27,Groceries
40906174,18315,0,-27990691,2017-10-27,2017-10-27,Rent
40906174,19109,0,-28009800,2017-10-28,2017-10-28,Rent
40906174,0,19041,-27990759,2017-10-28,2017-10-28,
40906174,0,18578,-27972181,2017-10-29,2017-10-29,
40906174,485454,0,-28457635,2017-10-30,2017-10-30,Entertainment
40906174,0,12005,-28445630,2017-10-30,2017-10-30,
40906174,734861,0,-29180491,2017-10-31,2017-10-31,Transportation
40906174,0,460889,-28719602,2017-10-31,2017-10-31,
40906174,590616,0,-29310218,2017-10-31,2017-10-31,Education
40906174,19346,0,-29329564,2017-11-01,2017-11-01,Entertainment
40906174,0,935584,-28393980,2017-11-01,2017-11-01,
40906174,726413,0,-27457438,2017-11-02,2017-11-02,Education
40906174,0,562449,-26894989,2017-11-03,2017-11-03,
40906174,0,14162,-26880827,2017-11-03,2017-11-03,
40906174,822675,0,-26894906,2017-11-03,2017-11-03,Education
40906174,586894,0,-27481800,2017-11-04,2017-11-04,Rent
40906174,733806,0,-28215606,2017-11-04,2017-11-04,Rent
40906174,12060,0,-28227666,2017-11-04,2017-11-04,Groceries
40906174,10616,0,-28238282,2017-11-05,2017-11-05,Transportation
40906174,0,415258,-27823024,2017-11-05,2017-11-05,
40906174,671711,0,-28494735,2017-11-06,2017-11-06,Entertainment
40906174,0,919677,-27575058,2017-11-06,2017-11-06,
40906174,0,581499,-26993559,2017-11-07,2017-11-07,
40906174,12504,0,-27006063,2017-11-08,2017-11-08,Education
40906174,0,804246,-26201817,2017-11-09,2017-11-09,
40906174,635643,0,-26837460,2017-11-09,2017-11-09,Transportation
40906174,798366,0,-27635826,2017-11-09,2017-11-09,Bill Sharing
40906174,0,737008,-26898818,2017-11-10,2017-11-10,
40906174,587255,0,-27486073,2017-11-11,2017-11-11,Rent
40906174,899675,0,-28385748,2017-11-12,2017-11-12,Utilities
40906174,10747,0,-28396495,2017-11-13,2017-11-13,Bill Sharing
40906174,453835,0,-28850330,2017-11-14,2017-11-14,Clothes
40906174,0,14413,-28835917,2017-11-14,2017-11-14,
40906174,761044,0,-27998465,2017-11-15,2017-11-15,Education
40906174,491346,0,-28489811,2017-11-16,2017-11-16,Groceries
40906174,477408,0,-28967219,2017-11-16,2017-11-16,Groceries
40906174,0,964417,-28002802,2017-11-17,2017-11-17,
40906174,0,16114,-27986688,2017-11-17,2017-11-17,
40906174,0,594319,-27392369,2017-11-17,2017-11-17,
40906174,0,15471,-27376898,2017-11-18,2017-11-18,
40906174,0,15866,-27361032,2017-11-18,2017-11-18,
40906174,768901,0,-28129933,2017-11-19,2017-11-19,Entertainment
40906174,0,656725,-27484500,2017-11-20,2017-11-20,
40906174,825639,0,-28310139,2017-11-20,2017-11-20,Entertainment
40906174,0,820760,-27489379,2017-11-20,2017-11-20,
40906174,12874,0,-27502253,2017-11-21,2017-11-21,Bill Sharing
40906174,15383,0,-27517636,2017-11-21,2017-11-21,Utilities
40906174,500946,0,-28018582,2017-11-22,2017-11-22,Healthcare
40906174,0,702912,-27315670,2017-11-22,2017-11-22,
40906174,547544,0,-27863214,2017-11-22,2017-11-22,Groceries
40906174,956870,0,-28820084,2017-11-23,2017-11-23,Rent
40906174,0,469888,-28350196,2017-11-23,2017-11-23,
40906174,896474,0,-29246670,2017-11-23,2017-11-23,Bill Sharing
40906174,0,580448,-29233204,2017-11-24,2017-11-24,
40906174,0,533030,-28700174,2017-11-24,2017-11-24,
40906174,0,889385,-27810789,2017-11-25,2017-11-25,
40906174,0,14984,-27795805,2017-11-26,2017-11-26,
40906174,14178,0,-27809983,2017-11-27,2017-11-27,Bill Sharing
40906174,555563,0,-27790520,2017-11-28,2017-11-28,Education
40906174,456630,0,-28247150,2017-11-28,2017-11-28,Entertainment
40906174,0,824584,-27422566,2017-11-29,2017-11-29,
40906174,664989,0,-28087555,2017-11-29,2017-11-29,Healthcare
40906174,0,874942,-27212613,2017-11-29,2017-11-29,
40906174,16629,0,-27229242,2017-11-30,2017-11-30,Education
40906174,436463,0,-27665705,2017-11-30,2017-11-30,Groceries
40906174,0,412891,-27252814,2017-11-30,2017-11-30,
40906174,0,19355,-27233459,2017-12-01,2017-12-01,
40906174,0,10428,-27223031,2017-12-01,2017-12-01,
40906174,17029,0,-27240060,2017-12-02,2017-12-02,Groceries
40906174,787012,0,-28027072,2017-12-03,2017-12-03,Bill Sharing
40906174,886739,0,-28913811,2017-12-03,2017-12-03,Utilities
40906174,0,878177,-28035634,2017-12-03,2017-12-03,
40906174,0,539486,-27496148,2017-12-04,2017-12-04,
40906174,494477,0,-27990625,2017-12-04,2017-12-04,Bill Sharing
40906174,14791,0,-28005416,2017-12-04,2017-12-04,Transportation
40906174,17734,0,-28023150,2017-12-05,2017-12-05,Transportation
40906174,0,707483,-27315667,2017-12-05,2017-12-05,
40906174,0,13865,-27301802,2017-12-06,2017-12-06,
40906174,0,14743,-27287059,2017-12-07,2017-12-07,
40906174,0,771053,-26516006,2017-12-07,2017-12-07,
40906174,13301,0,-26529307,2017-12-08,2017-12-08,Education
40906174,471810,0,-27001117,2017-12-09,2017-12-09,Utilities
40906174,437700,0,-27438817,2017-12-09,2017-12-09,Rent
40906174,0,653905,-26784912,2017-12-10,2017-12-10,
40906174,14479,0,-26799391,2017-12-10,2017-12-10,Entertainment
40906174,0,18570,-26780821,2017-12-10,2017-12-10,
40906174,0,708452,-26072369,2017-12-11,2017-12-11,
40906174,0,19214,-26053155,2017-12-11,2017-12-11,
40906174,0,452185,-25600970,2017-12-12,2017-12-12,
40906174,0,480427,-25120543,2017-12-12,2017-12-12,
40906174,0,449480,-24671063,2017-12-13,2017-12-13,
40906174,0,15146,-24655917,2017-12-13,2017-12-13,
40906174,742649,0,-25398566,2017-12-14,2017-12-14,Groceries
40906174,0,17596,-25380970,2017-12-15,2017-12-15,
40906174,19711,0,-25400681,2017-12-15,2017-12-15,Bill Sharing
40906174,798750,0,-26232852,2017-12-15,2017-12-15,Education
40906174,0,933002,-25299850,2017-12-16,2017-12-16,
40906174,0,16286,-25283564,2017-12-16,2017-12-16,
40906174,0,462043,-24821521,2017-12-17,2017-12-17,
40906174,0,424715,-24396806,2017-12-17,2017-12-17,
40906174,0,12975,-24383831,2017-12-18,2017-12-18,
40906174,11661,0,-24395492,2017-12-18,2017-12-18,Utilities
40906174,0,548321,-23847171,2017-12-19,2017-12-19,
40906174,0,673526,-23173645,2017-12-20,2017-12-20,
40906174,10225,0,-23183870,2017-12-20,2017-12-20,Bill Sharing
40906174,18650,0,-23202520,2017-12-21,2017-12-21,Education
40906174,12201,0,-23214721,2017-12-21,2017-12-21,Entertainment
40906174,0,19238,-23195483,2017-12-21,2017-12-21,
40906174,822174,0,-24017657,2017-12-22,2017-12-22,Clothes
40906174,19407,0,-24037064,2017-12-23,2017-12-23,Bill Sharing
40906174,16338,0,-24053402,2017-12-24,2017-12-24,Bill Sharing
40906174,0,12412,-24040990,2017-12-25,2017-12-25,
40906174,0,945838,-23095152,2017-12-26,2017-12-26,
40906174,743024,0,-23838176,2017-12-27,2017-12-27,Entertainment
40906174,0,16942,-23821234,2017-12-28,2017-12-28,
40906174,624189,0,-24445423,2017-12-28,2017-12-28,Healthcare
40906174,0,680465,-23764958,2017-12-28,2017-12-28,
40906174,0,15924,-23749034,2017-12-29,2017-12-29,
40906174,10738,0,-23759772,2017-12-29,2017-12-29,Rent
40906174,477900,0,-24237672,2017-12-30,2017-12-30,Utilities
40906174,0,792181,-23445491,2017-12-31,2017-12-31,
40906174,0,19415,-23426076,2017-12-31,2017-12-31,
40906174,0,674862,-22751214,2018-01-01,2018-01-01,
40906174,0,922210,-21829004,2018-01-02,2018-01-02,
40906174,0,887511,-20941493,2018-01-02,2018-01-02,
40906174,10971,0,-20952464,2018-01-02,2018-01-02,Rent
40906174,12196,0,-20964660,2018-01-03,2018-01-03,Rent
40906174,0,10519,-20954141,2018-01-03,2018-01-03,
40906174,768894,0,-20426744,2018-01-04,2018-01-04,Healthcare
40906174,0,668720,-20446523,2018-01-04,2018-01-04,
40906174,0,10737,-20435786,2018-01-04,2018-01-04,
40906174,916456,0,-21352242,2018-01-05,2018-01-05,Groceries
40906174,11249,0,-21363491,2018-01-05,2018-01-05,Groceries
40906174,808068,0,-22171559,2018-01-05,2018-01-05,Utilities
40906174,0,11476,-22160083,2018-01-06,2018-01-06,
40906174,15518,0,-22175601,2018-01-06,2018-01-06,Education
40906174,964275,0,-23139876,2018-01-07,2018-01-07,Healthcare
40906174,0,15514,-23124362,2018-01-07,2018-01-07,
40906174,0,939165,-22185197,2018-01-08,2018-01-08,
40906174,522259,0,-22707456,2018-01-09,2018-01-09,Education
40906174,0,980597,-21726859,2018-01-09,2018-01-09,
40906174,0,844216,-20882643,2018-01-09,2018-01-09,
40906174,16620,0,-20899263,2018-01-10,2018-01-10,Groceries
40906174,0,959709,-19939554,2018-01-11,2018-01-11,
40906174,563519,0,-20503073,2018-01-11,2018-01-11,Rent
40906174,0,930165,-19572908,2018-01-11,2018-01-11,
40906174,11330,0,-19584238,2018-01-12,2018-01-12,Transportation
40906174,0,764944,-18819294,2018-01-13,2018-01-13,
40906174,13019,0,-18832313,2018-01-13,2018-01-13,Utilities
40906174,0,976151,-17856162,2018-01-13,2018-01-13,
40906174,0,18435,-17837727,2018-01-14,2018-01-14,
40906174,0,905250,-16932477,2018-01-14,2018-01-14,
40906174,0,920740,-16011737,2018-01-14,2018-01-14,
40906174,0,688324,-15323413,2018-01-15,2018-01-15,
40906174,12137,0,-15335550,2018-01-15,2018-01-15,Utilities
40906174,0,12247,-15323303,2018-01-15,2018-01-15,
40906174,0,10597,-15312706,2018-01-16,2018-01-16,
40906174,0,880373,-14432333,2018-01-17,2018-01-17,
40906174,0,752831,-15105067,2018-01-17,2018-01-17,
40906174,16695,0,-15121762,2018-01-18,2018-01-18,Healthcare
40906174,0,977353,-14144409,2018-01-18,2018-01-18,
40906174,0,797429,-13346980,2018-01-19,2018-01-19,
40906174,900145,0,-14247125,2018-01-19,2018-01-19,Healthcare
40906174,534011,0,-14781136,2018-01-19,2018-01-19,Entertainment
40906174,414915,0,-15196051,2018-01-20,2018-01-20,Transportation
40906174,0,595028,-14601023,2018-01-20,2018-01-20,
40906174,934720,0,-15535743,2018-01-20,2018-01-20,Groceries
40906174,15781,0,-15551524,2018-01-21,2018-01-21,Entertainment
40906174,18243,0,-15569767,2018-01-22,2018-01-22,Groceries
40906174,12874,0,-15582641,2018-01-22,2018-01-22,Healthcare
40906174,17633,0,-15600274,2018-01-23,2018-01-23,Bill Sharing
40906174,0,18843,-15581431,2018-01-23,2018-01-23,
40906174,0,18218,-15563213,2018-01-24,2018-01-24,
40906174,404456,0,-15967669,2018-01-25,2018-01-25,Utilities
40906174,11026,0,-15978695,2018-01-26,2018-01-26,Utilities
40906174,15287,0,-15993982,2018-01-27,2018-01-27,Bill Sharing
40906174,0,12203,-15981779,2018-01-27,2018-01-27,
40906174,570423,0,-16552202,2018-01-28,2018-01-28,Utilities
40906174,19942,0,-16572144,2018-01-29,2018-01-29,Transportation
40906174,0,715519,-15856625,2018-01-30,2018-01-30,
40906174,13127,0,-15869752,2018-01-31,2018-01-31,Utilities
40906174,19407,0,-15889159,2018-01-31,2018-01-31,Bill Sharing
40906174,13284,0,-15902443,2018-01-31,2018-01-31,Clothes
40906174,15424,0,-15917867,2018-02-01,2018-02-01,Utilities
40906174,867864,0,-16785731,2018-02-01,2018-02-01,Healthcare
40906174,0,649730,-16136001,2018-02-01,2018-02-01,
40906174,0,535977,-15600024,2018-02-02,2018-02-02,
40906174,11574,0,-15611598,2018-02-02,2018-02-02,Education
40906174,696729,0,-16308327,2018-02-03,2018-02-03,Utilities
40906174,516920,0,-16825247,2018-02-03,2018-02-03,Utilities
40906174,11287,0,-16836534,2018-02-04,2018-02-04,Entertainment
40906174,0,10661,-16825873,2018-02-04,2018-02-04,
40906174,0,695076,-16130797,2018-02-04,2018-02-04,
40906174,0,19026,-16111771,2018-02-05,2018-02-05,
40906174,0,19901,-16091870,2018-02-05,2018-02-05,
40906174,18995,0,-16110865,2018-02-06,2018-02-06,Clothes
40906174,0,756204,-15354661,2018-02-06,2018-02-06,
40906174,0,528671,-14825990,2018-02-07,2018-02-07,
40906174,993869,0,-15819859,2018-02-08,2018-02-08,Bill Sharing
40906174,0,10765,-15809094,2018-02-08,2018-02-08,
40906174,0,914240,-14894854,2018-02-08,2018-02-08,
40906174,739444,0,-14015410,2018-02-09,2018-02-09,Healthcare
40906174,556870,0,-14572280,2018-02-09,2018-02-09,Transportation
40906174,18346,0,-14590626,2018-02-10,2018-02-10,Healthcare
40906174,661956,0,-15252582,2018-02-11,2018-02-11,Clothes
40906174,0,14994,-15237588,2018-02-12,2018-02-12,
40906174,17051,0,-15254639,2018-02-13,2018-02-13,Clothes
40906174,17775,0,-15272414,2018-02-14,2018-02-14,Education
40906174,0,19053,-15253361,2018-02-14,2018-02-14,
40906174,0,12980,-15240381,2018-02-14,2018-02-14,
40906174,0,940976,-14299405,2018-02-15,2018-02-15,
40906174,0,736923,-13714803,2018-02-15,2018-02-15,
40906174,522888,0,-14237691,2018-02-16,2018-02-16,Entertainment
40906174,0,13048,-14224643,2018-02-16,2018-02-16,
40906174,18416,0,-14243059,2018-02-16,2018-02-16,Entertainment
40906174,11853,0,-14254912,2018-02-17,2018-02-17,Transportation
40906174,17711,0,-14272623,2018-02-17,2018-02-17,Clothes
40906174,0,409782,-13862841,2018-02-18,2018-02-18,
40906174,0,17276,-13845565,2018-02-18,2018-02-18,
40906174,0,790538,-13055027,2018-02-19,2018-02-19,
40906174,0,600481,-12454546,2018-02-19,2018-02-19,
40906174,10564,0,-12465110,2018-02-19,2018-02-19,Utilities
40906174,0,568593,-11896517,2018-02-20,2018-02-20,
40906174,0,11363,-11885154,2018-02-21,2018-02-21,
40906174,693897,0,-12579051,2018-02-21,2018-02-21,Groceries
40906174,0,11874,-12567177,2018-02-21,2018-02-21,
40906174,0,443720,-12123457,2018-02-22,2018-02-22,
40906174,0,938055,-11185402,2018-02-22,2018-02-22,
40906174,0,520835,-10664567,2018-02-23,2018-02-23,
40906174,0,639994,-10024573,2018-02-23,2018-02-23,
40906174,0,563446,-9461127,2018-02-24,2018-02-24,
40906174,0,617351,-8843776,2018-02-24,2018-02-24,
40906174,0,904561,-7939215,2018-02-24,2018-02-24,
40906174,19552,0,-7958767,2018-02-25,2018-02-25,Groceries
40906174,0,17467,-7941300,2018-02-25,2018-02-25,
40906174,0,989337,-6951963,2018-02-26,2018-02-26,
40906174,782108,0,-7734071,2018-02-26,2018-02-26,Rent
40906174,15027,0,-7749098,2018-02-26,2018-02-26,Bill Sharing
40906174,960133,0,-8709231,2018-02-27,2018-02-27,Entertainment
40906174,15380,0,-8724611,2018-02-27,2018-02-27,Groceries
40906174,0,731711,-7992900,2018-02-27,2018-02-27,
40906174,691286,0,-8684186,2018-02-28,2018-02-28,Groceries
40906174,0,480522,-8203664,2018-02-28,2018-02-28,
40906174,19598,0,-8223262,2018-03-01,2018-03-01,Transportation
40906174,472213,0,-8695475,2018-03-01,2018-03-01,Healthcare
40906174,0,12402,-8683073,2018-03-02,2018-03-02,
40906174,593744,0,-9276817,2018-03-02,2018-03-02,Healthcare
40906174,979066,0,-9263138,2018-03-02,2018-03-02,Education
40906174,0,12900,-9250238,2018-03-03,2018-03-03,
40906174,917532,0,-10167770,2018-03-04,2018-03-04,Education
40906174,0,15753,-10152017,2018-03-05,2018-03-05,
40906174,0,828797,-9323220,2018-03-05,2018-03-05,
40906174,15721,0,-9338941,2018-03-05,2018-03-05,Utilities
40906174,537071,0,-9876012,2018-03-06,2018-03-06,Groceries
40906174,562825,0,-10438837,2018-03-06,2018-03-06,Rent
40906174,612197,0,-9937808,2018-03-06,2018-03-06,Education
40906174,0,658860,-9278948,2018-03-07,2018-03-07,
40906174,17945,0,-9296893,2018-03-07,2018-03-07,Clothes
40906174,13898,0,-9310791,2018-03-08,2018-03-08,Education
40906174,0,18998,-9291793,2018-03-09,2018-03-09,
40906174,0,17646,-9274147,2018-03-09,2018-03-09,
40906174,0,11499,-9262648,2018-03-10,2018-03-10,
40906174,0,16349,-9246299,2018-03-10,2018-03-10,
40906174,0,763079,-8483220,2018-03-10,2018-03-10,
40906174,421385,0,-8904605,2018-03-11,2018-03-11,Clothes
40906174,0,825383,-8079222,2018-03-12,2018-03-12,
40906174,859931,0,-8939153,2018-03-12,2018-03-12,Bill Sharing
40906174,0,11457,-8927696,2018-03-12,2018-03-12,
40906174,10024,0,-8937720,2018-03-13,2018-03-13,Utilities
40906174,11741,0,-8949461,2018-03-13,2018-03-13,Entertainment
40906174,0,17317,-8932144,2018-03-14,2018-03-14,
40906174,0,920487,-8011657,2018-03-14,2018-03-14,
40906174,711840,0,-8723497,2018-03-15,2018-03-15,Education
40906174,0,993586,-7729911,2018-03-15,2018-03-15,
40906174,0,899315,-6830596,2018-03-16,2018-03-16,
40906174,740849,0,-7571445,2018-03-17,2018-03-17,Groceries
40906174,796084,0,-8367529,2018-03-17,2018-03-17,Groceries
40906174,0,576042,-7791487,2018-03-17,2018-03-17,
40906174,0,592992,-7198495,2018-03-18,2018-03-18,
40906174,633489,0,-7831984,2018-03-18,2018-03-18,Bill Sharing
40906174,16303,0,-7848287,2018-03-19,2018-03-19,Entertainment
40906174,0,609630,-7238657,2018-03-19,2018-03-19,
40906174,574825,0,-7813482,2018-03-20,2018-03-20,Bill Sharing
40906174,0,623276,-7190206,2018-03-20,2018-03-20,
40906174,650057,0,-7840263,2018-03-20,2018-03-20,Rent
40906174,647974,0,-8488237,2018-03-21,2018-03-21,Utilities
40906174,0,919124,-7569113,2018-03-21,2018-03-21,
40906174,0,15094,-7554019,2018-03-21,2018-03-21,
40906174,10228,0,-7564247,2018-03-22,2018-03-22,Groceries
40906174,0,12782,-7551465,2018-03-22,2018-03-22,
40906174,0,10900,-7540565,2018-03-23,2018-03-23,
40906174,17273,0,-7557838,2018-03-23,2018-03-23,Education
40906174,12247,0,-7570085,2018-03-24,2018-03-24,Healthcare
40906174,810797,0,-8380882,2018-03-24,2018-03-24,Education
40906174,11376,0,-8392258,2018-03-25,2018-03-25,Education
40906174,415607,0,-8807865,2018-03-26,2018-03-26,Entertainment
40906174,0,13984,-8793881,2018-03-26,2018-03-26,
40906174,822362,0,-9616243,2018-03-26,2018-03-26,Bill Sharing
40906174,0,13169,-9603074,2018-03-27,2018-03-27,
40906174,0,582514,-9020560,2018-03-27,2018-03-27,
40906174,0,526424,-8494136,2018-03-27,2018-03-27,
40906174,654661,0,-9148797,2018-03-28,2018-03-28,Clothes
40906174,0,667324,-8481473,2018-03-28,2018-03-28,
40906174,10683,0,-8492156,2018-03-28,2018-03-28,Entertainment
40906174,0,822246,-7669910,2018-03-29,2018-03-29,
40906174,763097,0,-8433007,2018-03-30,2018-03-30,Rent
40906174,0,10508,-8422499,2018-03-30,2018-03-30,
40906174,0,19056,-8403443,2018-03-30,2018-03-30,
40906174,11685,0,-8415128,2018-03-31,2018-03-31,Utilities
40906174,17754,0,-8432882,2018-04-01,2018-04-01,Entertainment
40906174,558615,0,-8991497,2018-04-02,2018-04-02,Groceries
40906174,16705,0,-9008202,2018-04-02,2018-04-02,Transportation
40906174,10734,0,-9018936,2018-04-03,2018-04-03,Utilities
40906174,458306,0,-8040377,2018-04-04,2018-04-04,Healthcare
40906174,0,17727,-8022650,2018-04-04,2018-04-04,
40906174,911698,0,-8934348,2018-04-05,2018-04-05,Clothes
40906174,659232,0,-9593580,2018-04-05,2018-04-05,Entertainment
40906174,726356,0,-10319936,2018-04-05,2018-04-05,Clothes
40906174,409601,0,-10729537,2018-04-06,2018-04-06,Entertainment
40906174,0,11198,-10718339,2018-04-07,2018-04-07,
40906174,0,630866,-11561910,2018-04-07,2018-04-07,
40906174,409001,0,-11970911,2018-04-07,2018-04-07,Utilities
40906174,0,12956,-11957955,2018-04-08,2018-04-08,
40906174,635120,0,-12593075,2018-04-08,2018-04-08,Transportation
40906174,0,12416,-12580659,2018-04-08,2018-04-08,
40906174,0,669022,-11911637,2018-04-09,2018-04-09,
40906174,700027,0,-12611664,2018-04-09,2018-04-09,Clothes
40906174,0,18483,-12593181,2018-04-09,2018-04-09,
40906174,822508,0,-13415689,2018-04-10,2018-04-10,Groceries
40906174,0,14752,-13400937,2018-04-10,2018-04-10,
40906174,0,770117,-12630820,2018-04-11,2018-04-11,
40906174,15844,0,-12646664,2018-04-12,2018-04-12,Entertainment
40906174,571925,0,-13218589,2018-04-13,2018-04-13,Healthcare
40906174,407577,0,-13626166,2018-04-14,2018-04-14,Utilities
40906174,872353,0,-14498519,2018-04-14,2018-04-14,Bill Sharing
40906174,567127,0,-15065646,2018-04-15,2018-04-15,Bill Sharing
40906174,669253,0,-15734899,2018-04-15,2018-04-15,Healthcare
40906174,0,965433,-14769466,2018-04-15,2018-04-15,
40906174,0,15689,-14753777,2018-04-16,2018-04-16,
40906174,0,14037,-14739740,2018-04-17,2018-04-17,
40906174,0,838966,-13900774,2018-04-17,2018-04-17,
40906174,403451,0,-14304225,2018-04-17,2018-04-17,Utilities
40906174,0,16585,-14287640,2018-04-18,2018-04-18,
40906174,0,11186,-14276454,2018-04-19,2018-04-19,
40906174,691959,0,-13659984,2018-04-19,2018-04-19,Healthcare
40906174,530377,0,-14190361,2018-04-19,2018-04-19,Bill Sharing
40906174,470031,0,-14660392,2018-04-20,2018-04-20,Groceries
40906174,877948,0,-15538340,2018-04-21,2018-04-21,Bill Sharing
40906174,0,419302,-15119038,2018-04-22,2018-04-22,
40906174,0,12357,-15106681,2018-04-22,2018-04-22,
40906174,493742,0,-15600423,2018-04-22,2018-04-22,Utilities
40906174,16535,0,-15616958,2018-04-23,2018-04-23,Rent
40906174,0,14863,-15602095,2018-04-23,2018-04-23,
40906174,0,810152,-15113689,2018-04-23,2018-04-23,
40906174,11164,0,-15124853,2018-04-24,2018-04-24,Healthcare
40906174,0,896733,-14228120,2018-04-25,2018-04-25,
40906174,648093,0,-14876213,2018-04-26,2018-04-26,Clothes
40906174,0,699519,-14176694,2018-04-26,2018-04-26,
40906174,0,808227,-13368467,2018-04-26,2018-04-26,
40906174,0,821115,-12547352,2018-04-27,2018-04-27,
40906174,811413,0,-13358765,2018-04-27,2018-04-27,Education
40906174,0,791325,-12567440,2018-04-28,2018-04-28,
40906174,0,562355,-12005085,2018-04-28,2018-04-28,
40906174,0,13867,-11991218,2018-04-29,2018-04-29,
40906174,0,851977,-11139241,2018-04-29,2018-04-29,
40906174,607255,0,-11746496,2018-04-29,2018-04-29,Clothes
40906174,0,17995,-11728501,2018-04-30,2018-04-30,
40906174,914135,0,-12689264,2018-04-30,2018-04-30,Education
40906174,904941,0,-13594205,2018-04-30,2018-04-30,Healthcare
40906174,0,630852,-12963353,2018-05-01,2018-05-01,
40906174,0,797262,-12166091,2018-05-01,2018-05-01,
40906174,990431,0,-13156522,2018-05-02,2018-05-02,Groceries
40906174,0,14639,-13141883,2018-05-02,2018-05-02,
40906174,19092,0,-13160975,2018-05-03,2018-05-03,Rent
40906174,0,12329,-13148646,2018-05-04,2018-05-04,
40906174,0,17448,-13131198,2018-05-04,2018-05-04,
40906174,806198,0,-13937396,2018-05-04,2018-05-04,Groceries
40906174,0,649941,-13287455,2018-05-05,2018-05-05,
40906174,753355,0,-14040810,2018-05-05,2018-05-05,Transportation
40906174,0,13130,-14027680,2018-05-06,2018-05-06,
40906174,989023,0,-15016703,2018-05-07,2018-05-07,Healthcare
40906174,0,966085,-14050618,2018-05-08,2018-05-08,
40906174,0,774667,-13275951,2018-05-08,2018-05-08,
40906174,0,422970,-12852981,2018-05-08,2018-05-08,
40906174,816347,0,-13669328,2018-05-09,2018-05-09,Clothes
40906174,0,513332,-13155996,2018-05-09,2018-05-09,
40906174,719289,0,-13875285,2018-05-09,2018-05-09,Utilities
40906174,816468,0,-14691753,2018-05-10,2018-05-10,Transportation
40906174,0,999218,-13692535,2018-05-10,2018-05-10,
40906174,778363,0,-14470898,2018-05-11,2018-05-11,Utilities
40906174,932620,0,-14483984,2018-05-11,2018-05-11,Education
40906174,0,599126,-13884858,2018-05-11,2018-05-11,
40906174,0,801800,-13083058,2018-05-12,2018-05-12,
40906174,681904,0,-13764962,2018-05-12,2018-05-12,Bill Sharing
40906174,0,13786,-13751176,2018-05-13,2018-05-13,
40906174,861825,0,-14613001,2018-05-14,2018-05-14,Rent
40906174,17529,0,-14630530,2018-05-14,2018-05-14,Healthcare
40906174,918314,0,-15548844,2018-05-15,2018-05-15,Bill Sharing
40906174,0,944566,-14604278,2018-05-15,2018-05-15,
40906174,0,12100,-14592178,2018-05-15,2018-05-15,
40906174,0,14968,-14577210,2018-05-16,2018-05-16,
40906174,649591,0,-15226801,2018-05-17,2018-05-17,Bill Sharing
40906174,450257,0,-15677058,2018-05-17,2018-05-17,Transportation
40906174,0,999511,-14677547,2018-05-17,2018-05-17,
40906174,14671,0,-14692218,2018-05-18,2018-05-18,Utilities
40906174,553426,0,-15245644,2018-05-19,2018-05-19,Utilities
40906174,12222,0,-15257866,2018-05-19,2018-05-19,Utilities
40906174,0,19295,-15238571,2018-05-19,2018-05-19,
40906174,747056,0,-15985627,2018-05-20,2018-05-20,Utilities
40906174,16998,0,-16002625,2018-05-21,2018-05-21,Education
40906174,447602,0,-16450227,2018-05-22,2018-05-22,Clothes
40906174,0,16818,-16433409,2018-05-22,2018-05-22,
40906174,0,837758,-15595651,2018-05-22,2018-05-22,
40906174,0,719702,-14875949,2018-05-23,2018-05-23,
40906174,13770,0,-14889719,2018-05-23,2018-05-23,Clothes
40906174,0,10470,-14879249,2018-05-23,2018-05-23,
40906174,566202,0,-15445451,2018-05-24,2018-05-24,Groceries
40906174,16978,0,-15462429,2018-05-25,2018-05-25,Utilities
40906174,0,544248,-14918181,2018-05-25,2018-05-25,
40906174,0,790600,-14127581,2018-05-26,2018-05-26,
40906174,0,498203,-13629378,2018-05-27,2018-05-27,
40906174,0,612653,-13016725,2018-05-27,2018-05-27,
40906174,0,829458,-12187267,2018-05-28,2018-05-28,
40906174,11479,0,-12198746,2018-05-28,2018-05-28,Bill Sharing
40906174,719581,0,-12918327,2018-05-29,2018-05-29,Utilities
40906174,15898,0,-12934225,2018-05-29,2018-05-29,Bill Sharing
40906174,12351,0,-12946576,2018-05-30,2018-05-30,Clothes
40906174,18050,0,-12964626,2018-05-30,2018-05-30,Healthcare
40906174,917820,0,-13882446,2018-05-31,2018-05-31,Rent
40906174,0,532552,-13349894,2018-05-31,2018-05-31,
40906174,821019,0,-14170913,2018-05-31,2018-05-31,Entertainment
40906174,0,17218,-14153695,2018-06-01,2018-06-01,
40906174,532420,0,-14686115,2018-06-02,2018-06-02,Education
40906174,10634,0,-14696749,2018-06-02,2018-06-02,Bill Sharing
40906174,704780,0,-15401529,2018-06-02,2018-06-02,Clothes
40906174,0,447908,-14953621,2018-06-03,2018-06-03,
40906174,0,976556,-13977065,2018-06-03,2018-06-03,
40906174,0,960257,-14602077,2018-06-03,2018-06-03,
40906174,579712,0,-15181789,2018-06-04,2018-06-04,Utilities
40906174,0,886777,-14295012,2018-06-04,2018-06-04,
40906174,536351,0,-14831363,2018-06-05,2018-06-05,Healthcare
40906174,587925,0,-15419288,2018-06-05,2018-06-05,Entertainment
40906174,16649,0,-15435937,2018-06-05,2018-06-05,Education
40906174,430328,0,-15425341,2018-06-06,2018-06-06,Healthcare
40906174,0,858545,-14566796,2018-06-06,2018-06-06,
40906174,15341,0,-14582137,2018-06-07,2018-06-07,Clothes
40906174,0,573999,-14008138,2018-06-07,2018-06-07,
40906174,11209,0,-14019347,2018-06-08,2018-06-08,Transportation
40906174,530422,0,-14549769,2018-06-08,2018-06-08,Rent
40906174,0,19713,-14530056,2018-06-09,2018-06-09,
40906174,0,13632,-14516424,2018-06-09,2018-06-09,
40906174,12893,0,-14529317,2018-06-10,2018-06-10,Transportation
40906174,0,10857,-14518460,2018-06-11,2018-06-11,
40906174,0,886491,-13631969,2018-06-12,2018-06-12,
40906174,880771,0,-14534655,2018-06-12,2018-06-12,Healthcare
40906174,0,555435,-13979220,2018-06-12,2018-06-12,
40906174,887017,0,-14866237,2018-06-13,2018-06-13,Healthcare
40906174,15288,0,-14881525,2018-06-14,2018-06-14,Education
40906174,0,910392,-13971133,2018-06-14,2018-06-14,
40906174,0,745006,-13226127,2018-06-14,2018-06-14,
40906174,520113,0,-13746240,2018-06-15,2018-06-15,Clothes
40906174,967763,0,-14714003,2018-06-16,2018-06-16,Utilities
40906174,0,15732,-14698271,2018-06-16,2018-06-16,
40906174,532676,0,-15230947,2018-06-17,2018-06-17,Rent
40906174,0,13494,-15217453,2018-06-18,2018-06-18,
40906174,0,11546,-15205907,2018-06-19,2018-06-19,
40906174,707412,0,-15913319,2018-06-19,2018-06-19,Rent
40906174,984890,0,-16898209,2018-06-20,2018-06-20,Bill Sharing
40906174,654598,0,-17552807,2018-06-20,2018-06-20,Healthcare
40906174,14136,0,-17566943,2018-06-20,2018-06-20,Rent
40906174,804735,0,-18371678,2018-06-21,2018-06-21,Utilities
40906174,19477,0,-18391155,2018-06-22,2018-06-22,Entertainment
40906174,0,917038,-17474117,2018-06-22,2018-06-22,
40906174,10825,0,-17484942,2018-06-22,2018-06-22,Clothes
40906174,0,838959,-16645983,2018-06-23,2018-06-23,
40906174,15419,0,-16661402,2018-06-24,2018-06-24,Healthcare
40906174,441046,0,-17102448,2018-06-25,2018-06-25,Transportation
40906174,18392,0,-17120840,2018-06-25,2018-06-25,Clothes
40906174,779787,0,-17900627,2018-06-26,2018-06-26,Bill Sharing
40906174,14647,0,-17915274,2018-06-26,2018-06-26,Entertainment
40906174,654194,0,-18569468,2018-06-27,2018-06-27,Groceries
40906174,971405,0,-19540873,2018-06-27,2018-06-27,Transportation
40906174,0,690720,-18850153,2018-06-27,2018-06-27,
40906174,527146,0,-19377299,2018-06-28,2018-06-28,Groceries
40906174,17274,0,-19394573,2018-06-29,2018-06-29,Transportation
40906174,0,19241,-19375332,2018-06-29,2018-06-29,
40906174,499891,0,-19875223,2018-06-29,2018-06-29,Entertainment
40906174,725044,0,-20600267,2018-06-30,2018-06-30,Transportation
40906174,0,17085,-20583182,2018-06-30,2018-06-30,
40906174,0,971146,-19612036,2018-06-30,2018-06-30,
40906174,0,14003,-19598033,2018-07-01,2018-07-01,
40906174,0,15260,-19582773,2018-07-02,2018-07-02,
40906174,0,542282,-19040491,2018-07-02,2018-07-02,
40906174,0,617416,-18423075,2018-07-02,2018-07-02,
40906174,0,419066,-18004009,2018-07-03,2018-07-03,
40906174,0,595975,-17408034,2018-07-03,2018-07-03,
40906174,877886,0,-17424278,2018-07-04,2018-07-04,Healthcare
40906174,0,932854,-16491424,2018-07-05,2018-07-05,
40906174,0,12959,-16478465,2018-07-05,2018-07-05,
40906174,503477,0,-16981942,2018-07-05,2018-07-05,Rent
40906174,0,456515,-16998090,2018-07-06,2018-07-06,
40906174,13625,0,-17011715,2018-07-07,2018-07-07,Transportation
40906174,0,586153,-16425562,2018-07-08,2018-07-08,
40906174,0,700533,-15725029,2018-07-08,2018-07-08,
40906174,0,563143,-14952737,2018-07-08,2018-07-08,
40906174,0,474881,-14477856,2018-07-09,2018-07-09,
40906174,16099,0,-14493955,2018-07-10,2018-07-10,Healthcare
40906174,0,11392,-14482563,2018-07-10,2018-07-10,
40906174,0,17938,-14464625,2018-07-11,2018-07-11,
40906174,527946,0,-14992571,2018-07-11,2018-07-11,Groceries
40906174,932622,0,-15925193,2018-07-11,2018-07-11,Groceries
40906174,0,501430,-15423763,2018-07-12,2018-07-12,
40906174,0,951935,-14471828,2018-07-12,2018-07-12,
40906174,0,876701,-13595127,2018-07-13,2018-07-13,
40906174,0,906937,-12688190,2018-07-13,2018-07-13,
40906174,0,19341,-12668849,2018-07-14,2018-07-14,
40906174,0,890725,-11778124,2018-07-15,2018-07-15,
40906174,19435,0,-11797559,2018-07-15,2018-07-15,Clothes
40906174,0,448571,-11348988,2018-07-15,2018-07-15,
40906174,0,10158,-11338830,2018-07-16,2018-07-16,
40906174,630007,0,-11968837,2018-07-16,2018-07-16,Entertainment
40906174,0,13568,-11955269,2018-07-16,2018-07-16,
40906174,0,612737,-11342532,2018-07-17,2018-07-17,
40906174,0,979906,-10362626,2018-07-18,2018-07-18,
40906174,0,999594,-9363032,2018-07-18,2018-07-18,
40906174,707755,0,-10070787,2018-07-19,2018-07-19,Groceries
40906174,0,490678,-9580109,2018-07-20,2018-07-20,
40906174,0,17550,-9562559,2018-07-20,2018-07-20,
40906174,930019,0,-10492578,2018-07-20,2018-07-20,Clothes
40906174,0,10697,-10481881,2018-07-21,2018-07-21,
40906174,0,10692,-10471189,2018-07-21,2018-07-21,
40906174,631869,0,-11103058,2018-07-21,2018-07-21,Utilities
40906174,996585,0,-12099643,2018-07-22,2018-07-22,Education
40906174,0,10862,-12088781,2018-07-22,2018-07-22,
40906174,0,797550,-11291231,2018-07-23,2018-07-23,
40906174,461283,0,-11752514,2018-07-23,2018-07-23,Utilities
40906174,0,406610,-11345904,2018-07-24,2018-07-24,
40906174,0,540650,-10805254,2018-07-24,2018-07-24,
40906174,0,984569,-9820685,2018-07-25,2018-07-25,
40906174,0,818648,-9002037,2018-07-25,2018-07-25,
40906174,13079,0,-9015116,2018-07-26,2018-07-26,Bill Sharing
40906174,0,17283,-8997833,2018-07-27,2018-07-27,
40906174,966828,0,-9964661,2018-07-27,2018-07-27,Utilities
40906174,0,960527,-9004134,2018-07-27,2018-07-27,
40906174,16496,0,-9020630,2018-07-28,2018-07-28,Entertainment
40906174,0,961944,-8058686,2018-07-29,2018-07-29,
40906174,0,19321,-8039365,2018-07-29,2018-07-29,
40906174,0,16045,-8023320,2018-07-29,2018-07-29,
40906174,0,566928,-7456392,2018-07-30,2018-07-30,
40906174,11391,0,-7467783,2018-07-30,2018-07-30,Clothes
40906174,0,17721,-7450062,2018-07-30,2018-07-30,
40906174,0,16048,-7434014,2018-07-31,2018-07-31,
40906174,0,524471,-6909543,2018-07-31,2018-07-31,
40906174,535382,0,-7444925,2018-08-01,2018-08-01,Rent
40906174,19622,0,-7464547,2018-08-01,2018-08-01,Groceries
40906174,0,857633,-6606914,2018-08-02,2018-08-02,
40906174,0,491169,-6115745,2018-08-03,2018-08-03,
40906174,926819,0,-7042564,2018-08-03,2018-08-03,Education
40906174,583150,0,-7625714,2018-08-03,2018-08-03,Transportation
40906174,0,532027,-7093687,2018-08-04,2018-08-04,
40906174,588736,0,-7682423,2018-08-04,2018-08-04,Clothes
40906174,0,19655,-7662768,2018-08-05,2018-08-05,
40906174,16554,0,-7679322,2018-08-05,2018-08-05,Entertainment
40906174,14672,0,-7693994,2018-08-06,2018-08-06,Entertainment
40906174,16634,0,-7710628,2018-08-06,2018-08-06,Education
40906174,439043,0,-8149671,2018-08-07,2018-08-07,Clothes
40906174,17903,0,-8167574,2018-08-07,2018-08-07,Utilities
40906174,18078,0,-8185652,2018-08-07,2018-08-07,Utilities
40906174,0,17323,-8168329,2018-08-08,2018-08-08,
40906174,581229,0,-8749558,2018-08-08,2018-08-08,Education
40906174,0,890078,-7859480,2018-08-08,2018-08-08,
40906174,0,665299,-7194181,2018-08-09,2018-08-09,
40906174,0,942435,-6251746,2018-08-09,2018-08-09,
40906174,0,496588,-5755158,2018-08-09,2018-08-09,
40906174,0,996942,-4758216,2018-08-10,2018-08-10,
40906174,0,892515,-3865701,2018-08-11,2018-08-11,
40906174,0,16845,-3848856,2018-08-11,2018-08-11,
40906174,15634,0,-3864490,2018-08-12,2018-08-12,Groceries
40906174,0,12547,-3851943,2018-08-12,2018-08-12,
40906174,0,939678,-2912265,2018-08-12,2018-08-12,
40906174,0,14043,-2898222,2018-08-13,2018-08-13,
40906174,0,403763,-2494459,2018-08-14,2018-08-14,
40906174,727576,0,-3222035,2018-08-15,2018-08-15,Rent
40906174,0,16510,-3205525,2018-08-16,2018-08-16,
40906174,0,18260,-3187265,2018-08-17,2018-08-17,
40906174,0,873920,-2313345,2018-08-17,2018-08-17,
40906174,749788,0,-3063133,2018-08-18,2018-08-18,Rent
40906174,0,16425,-3046708,2018-08-18,2018-08-18,
40906174,0,460797,-3060768,2018-08-19,2018-08-19,
40906174,846577,0,-3907345,2018-08-19,2018-08-19,Utilities
40906174,900897,0,-4808242,2018-08-20,2018-08-20,Entertainment
40906174,599314,0,-5407556,2018-08-20,2018-08-20,Rent
40906174,0,17182,-5390374,2018-08-21,2018-08-21,
40906174,0,740392,-4649982,2018-08-21,2018-08-21,
40906174,474578,0,-5124560,2018-08-22,2018-08-22,Rent
40906174,0,883935,-4240625,2018-08-22,2018-08-22,
40906174,0,885783,-3354842,2018-08-23,2018-08-23,
40906174,10025,0,-3364867,2018-08-23,2018-08-23,Bill Sharing
40906174,0,868186,-2496681,2018-08-23,2018-08-23,
40906174,0,14623,-2482058,2018-08-24,2018-08-24,
40906174,856520,0,-3338578,2018-08-24,2018-08-24,Utilities
40906174,0,10885,-3327693,2018-08-25,2018-08-25,
40906174,759516,0,-4087209,2018-08-25,2018-08-25,Education
40906174,0,12415,-4074794,2018-08-26,2018-08-26,
40906174,832018,0,-4906812,2018-08-27,2018-08-27,Rent
40906174,0,939125,-3967687,2018-08-28,2018-08-28,
40906174,17104,0,-3984791,2018-08-28,2018-08-28,Healthcare
40906174,0,512996,-3471795,2018-08-28,2018-08-28,
40906174,528659,0,-4000454,2018-08-29,2018-08-29,Education
40906174,13209,0,-4013663,2018-08-29,2018-08-29,Utilities
40906174,512939,0,-4526602,2018-08-29,2018-08-29,Bill Sharing
40906174,0,12575,-4514027,2018-08-30,2018-08-30,
40906174,0,944070,-3569957,2018-08-30,2018-08-30,
40906174,0,18046,-3551911,2018-08-30,2018-08-30,
40906174,766758,0,-4318669,2018-08-31,2018-08-31,Education
40906174,0,755851,-3562818,2018-09-01,2018-09-01,
40906174,19533,0,-3582351,2018-09-01,2018-09-01,Rent
40906174,0,763964,-2818387,2018-09-01,2018-09-01,
40906174,538443,0,-3356830,2018-09-02,2018-09-02,Bill Sharing
40906174,529893,0,-3886723,2018-09-02,2018-09-02,Education
40906174,861450,0,-4748173,2018-09-02,2018-09-02,Entertainment
40906174,446759,0,-5194932,2018-09-03,2018-09-03,Utilities
40906174,18874,0,-5213806,2018-09-04,2018-09-04,Transportation
40906174,11084,0,-5224890,2018-09-05,2018-09-05,Healthcare
40906174,0,465900,-4280974,2018-09-06,2018-09-06,
40906174,723159,0,-5004133,2018-09-06,2018-09-06,Groceries
40906174,0,983457,-4020676,2018-09-06,2018-09-06,
40906174,0,13722,-4006954,2018-09-07,2018-09-07,
40906174,0,13432,-3993522,2018-09-07,2018-09-07,
40906174,993679,0,-4987201,2018-09-08,2018-09-08,Bill Sharing
40906174,0,665370,-4321831,2018-09-08,2018-09-08,
40906174,955464,0,-5277295,2018-09-08,2018-09-08,Bill Sharing
40906174,797781,0,-6075076,2018-09-09,2018-09-09,Clothes
40906174,0,16914,-6058162,2018-09-09,2018-09-09,
40906174,0,461528,-5596634,2018-09-10,2018-09-10,
40906174,0,566680,-5029954,2018-09-11,2018-09-11,
40906174,0,14829,-5015125,2018-09-11,2018-09-11,
40906174,559870,0,-5574995,2018-09-11,2018-09-11,Rent
40906174,717626,0,-6292621,2018-09-12,2018-09-12,Transportation
40906174,787428,0,-7080049,2018-09-13,2018-09-13,Entertainment
40906174,689973,0,-7770022,2018-09-13,2018-09-13,Rent
40906174,0,475157,-7294865,2018-09-13,2018-09-13,
40906174,19114,0,-7313979,2018-09-14,2018-09-14,Education
40906174,885876,0,-8199855,2018-09-15,2018-09-15,Utilities
40906174,0,542137,-7657718,2018-09-16,2018-09-16,
40906174,16992,0,-7674710,2018-09-17,2018-09-17,Groceries
40906174,0,13617,-7661093,2018-09-18,2018-09-18,
40906174,10882,0,-7671975,2018-09-19,2018-09-19,Rent
40906174,487821,0,-8159796,2018-09-19,2018-09-19,Transportation
40906174,10081,0,-8169877,2018-09-19,2018-09-19,Healthcare
40906174,0,452706,-7717171,2018-09-20,2018-09-20,
40906174,708974,0,-8426145,2018-09-21,2018-09-21,Utilities
40906174,13287,0,-8439432,2018-09-22,2018-09-22,Utilities
40906174,0,481206,-7958226,2018-09-22,2018-09-22,
40906174,0,452364,-7505862,2018-09-23,2018-09-23,
40906174,624758,0,-8130620,2018-09-23,2018-09-23,Clothes
40906174,0,685259,-7445361,2018-09-24,2018-09-24,
40906174,432052,0,-7877413,2018-09-25,2018-09-25,Utilities
40906174,0,781357,-7096056,2018-09-25,2018-09-25,
40906174,0,577080,-6518976,2018-09-25,2018-09-25,
40906174,642496,0,-7161472,2018-09-26,2018-09-26,Healthcare
40906174,0,833779,-6327693,2018-09-27,2018-09-27,
40906174,0,14745,-6312948,2018-09-27,2018-09-27,
40906174,15429,0,-6328377,2018-09-28,2018-09-28,Transportation
40906174,0,912526,-5415851,2018-09-29,2018-09-29,
40906174,0,942891,-4472960,2018-09-29,2018-09-29,
40906174,860490,0,-5333450,2018-09-30,2018-09-30,Transportation
40906174,772754,0,-6106204,2018-09-30,2018-09-30,Education
40906174,0,957986,-5148218,2018-10-01,2018-10-01,
40906174,12583,0,-5160801,2018-10-02,2018-10-02,Bill Sharing
40906174,0,552280,-4608521,2018-10-02,2018-10-02,
40906174,0,648016,-3960505,2018-10-03,2018-10-03,
40906174,0,521563,-3438942,2018-10-03,2018-10-03,
40906174,514010,0,-3952952,2018-10-04,2018-10-04,Groceries
40906174,0,928582,-3024370,2018-10-04,2018-10-04,
40906174,17696,0,-3042066,2018-10-04,2018-10-04,Clothes
40906174,0,668915,-2373151,2018-10-05,2018-10-05,
40906174,0,404396,-1968755,2018-10-06,2018-10-06,
40906174,0,523574,-1949078,2018-10-07,2018-10-07,
40906174,0,15807,-1933271,2018-10-07,2018-10-07,
40906174,827561,0,-2760832,2018-10-07,2018-10-07,Entertainment
40906174,0,588407,-2172425,2018-10-08,2018-10-08,
40906174,726263,0,-2898688,2018-10-08,2018-10-08,Utilities
40906174,545775,0,-3444463,2018-10-09,2018-10-09,Bill Sharing
40906174,0,10807,-3433656,2018-10-09,2018-10-09,
40906174,17646,0,-3451302,2018-10-09,2018-10-09,Healthcare
40906174,0,801657,-2649645,2018-10-10,2018-10-10,
40906174,12713,0,-2662358,2018-10-11,2018-10-11,Groceries
40906174,13348,0,-2675706,2018-10-11,2018-10-11,Education
40906174,0,996300,-1679406,2018-10-11,2018-10-11,
40906174,18713,0,-1698119,2018-10-12,2018-10-12,Entertainment
40906174,0,17296,-1680823,2018-10-12,2018-10-12,
40906174,0,16821,-1664002,2018-10-13,2018-10-13,
40906174,13013,0,-1677015,2018-10-13,2018-10-13,Healthcare
40906174,0,480684,-1196331,2018-10-13,2018-10-13,
40906174,19446,0,-1215777,2018-10-14,2018-10-14,Healthcare
40906174,988044,0,-781258,2018-10-14,2018-10-14,Healthcare
40906174,0,16775,-764483,2018-10-14,2018-10-14,
40906174,818689,0,-1583172,2018-10-15,2018-10-15,Utilities
40906174,0,872937,-710235,2018-10-16,2018-10-16,
40906174,465365,0,-1175600,2018-10-16,2018-10-16,Utilities
40906174,0,10456,-1165144,2018-10-17,2018-10-17,
40906174,0,700750,-464394,2018-10-18,2018-10-18,
40906174,15812,0,-480206,2018-10-18,2018-10-18,Groceries
40906174,15619,0,-495825,2018-10-18,2018-10-18,Healthcare
40906174,0,14891,-480934,2018-10-19,2018-10-19,
40906174,0,751848,270914,2018-10-19,2018-10-19,
40906174,616256,0,-345342,2018-10-19,2018-10-19,Utilities
40906174,0,969562,624220,2018-10-20,2018-10-20,
40906174,410336,0,213884,2018-10-20,2018-10-20,Education
40906174,462367,0,-248483,2018-10-21,2018-10-21,Rent
40906174,17540,0,-266023,2018-10-21,2018-10-21,Bill Sharing
40906174,0,715004,448981,2018-10-21,2018-10-21,
40906174,17878,0,431103,2018-10-22,2018-10-22,Healthcare
40906174,0,16938,-448041,2018-10-22,2018-10-22,
40906174,0,708138,-260097,2018-10-22,2018-10-22,
40906174,681554,0,-941651,2018-10-23,2018-10-23,Groceries
40906174,0,990961,49310,2018-10-24,2018-10-24,
40906174,11616,0,37694,2018-10-25,2018-10-25,Clothes
40906174,558044,0,-520350,2018-10-25,2018-10-25,Entertainment
40906174,0,430437,-89913,2018-10-25,2018-10-25,
40906174,0,740345,650432,2018-10-26,2018-10-26,
40906174,11092,0,639340,2018-10-26,2018-10-26,Entertainment
40906174,19486,0,619854,2018-10-27,2018-10-27,Education
40906174,0,11877,631731,2018-10-27,2018-10-27,
40906174,0,14793,646524,2018-10-27,2018-10-27,
40906174,587728,0,58796,2018-10-28,2018-10-28,Utilities
40906174,0,815420,-874216,2018-10-28,2018-10-28,
40906174,0,14434,-859782,2018-10-28,2018-10-28,
40906174,519078,0,-1378860,2018-10-29,2018-10-29,Healthcare
40906174,0,11636,-1367224,2018-10-30,2018-10-30,
40906174,970892,0,-2338116,2018-10-31,2018-10-31,Utilities
40906174,0,926380,-1411736,2018-10-31,2018-10-31,
40906174,0,646720,-765016,2018-11-01,2018-11-01,
40906174,0,769477,4461,2018-11-02,2018-11-02,
40906174,17927,0,-13466,2018-11-03,2018-11-03,Utilities
40906174,0,948739,-935273,2018-11-03,2018-11-03,
40906174,490789,0,-1426062,2018-11-03,2018-11-03,Education
40906174,13135,0,-1439197,2018-11-04,2018-11-04,Transportation
40906174,0,804678,-634519,2018-11-04,2018-11-04,
40906174,0,477042,-157477,2018-11-04,2018-11-04,
40906174,0,998107,840630,2018-11-05,2018-11-05,
40906174,11369,0,829261,2018-11-05,2018-11-05,Transportation
40906174,17733,0,-811528,2018-11-05,2018-11-05,Groceries
40906174,0,931546,-120018,2018-11-06,2018-11-06,
40906174,611335,0,-731353,2018-11-07,2018-11-07,Education
40906174,11571,0,-742924,2018-11-07,2018-11-07,Clothes
40906174,0,14784,-728140,2018-11-07,2018-11-07,
40906174,0,16689,-711451,2018-11-08,2018-11-08,
40906174,13481,0,-724932,2018-11-08,2018-11-08,Rent
40906174,841705,0,-1566637,2018-11-08,2018-11-08,Healthcare
40906174,0,16974,-1549663,2018-11-09,2018-11-09,
40906174,0,15523,-1534140,2018-11-09,2018-11-09,
40906174,16582,0,-1550722,2018-11-10,2018-11-10,Healthcare
40906174,0,11366,-1539356,2018-11-10,2018-11-10,
40906174,0,532500,-1006856,2018-11-11,2018-11-11,
40906174,421442,0,-1428298,2018-11-12,2018-11-12,Entertainment
40906174,910338,0,-1417030,2018-11-12,2018-11-12,Education
40906174,0,10395,-1406635,2018-11-12,2018-11-12,
40906174,749560,0,-2156195,2018-11-13,2018-11-13,Rent
40906174,633808,0,-2790003,2018-11-14,2018-11-14,Groceries
40906174,0,614447,-2175556,2018-11-14,2018-11-14,
40906174,0,16994,-2158562,2018-11-15,2018-11-15,
40906174,15686,0,-2174248,2018-11-15,2018-11-15,Utilities
40906174,0,637843,-1536405,2018-11-16,2018-11-16,
40906174,0,561929,-974476,2018-11-17,2018-11-17,
40906174,678317,0,-1652793,2018-11-17,2018-11-17,Transportation
40906174,0,12033,-1640760,2018-11-17,2018-11-17,
40906174,880332,0,-2394709,2018-11-18,2018-11-18,Education
40906174,0,15912,-2378797,2018-11-18,2018-11-18,
40906174,576300,0,-2955097,2018-11-18,2018-11-18,Education
40906174,0,877615,-2077482,2018-11-19,2018-11-19,
40906174,18822,0,-2096304,2018-11-19,2018-11-19,Utilities
40906174,0,749566,-1346738,2018-11-19,2018-11-19,
40906174,0,11081,-1335657,2018-11-20,2018-11-20,
40906174,939586,0,-2275243,2018-11-20,2018-11-20,Clothes
40906174,479490,0,-2754733,2018-11-20,2018-11-20,Rent
40906174,0,19365,-2735368,2018-11-21,2018-11-21,
40906174,0,648144,-3191479,2018-11-21,2018-11-21,
40906174,0,491749,-2699730,2018-11-21,2018-11-21,
40906174,0,12168,-2687562,2018-11-22,2018-11-22,
40906174,15440,0,-2703002,2018-11-23,2018-11-23,Bill Sharing
40906174,974001,0,-3677003,2018-11-23,2018-11-23,Entertainment
40906174,839318,0,-4516321,2018-11-24,2018-11-24,Rent
40906174,15404,0,-4531725,2018-11-24,2018-11-24,Transportation
40906174,480452,0,-5012177,2018-11-25,2018-11-25,Groceries
40906174,16546,0,-5028723,2018-11-25,2018-11-25,Utilities
40906174,494740,0,-5523463,2018-11-26,2018-11-26,Healthcare
40906174,0,723270,-4800193,2018-11-26,2018-11-26,
40906174,14608,0,-4814801,2018-11-27,2018-11-27,Education
40906174,0,14973,-4799828,2018-11-27,2018-11-27,
40906174,12260,0,-4812088,2018-11-27,2018-11-27,Education
40906174,408594,0,-5220682,2018-11-28,2018-11-28,Groceries
40906174,441791,0,-5662473,2018-11-28,2018-11-28,Rent
40906174,11257,0,-5673730,2018-11-29,2018-11-29,Education
40906174,17614,0,-5691344,2018-11-30,2018-11-30,Clothes
40906174,0,516353,-5174991,2018-11-30,2018-11-30,
40906174,915993,0,-6090984,2018-11-30,2018-11-30,Education
40906174,685968,0,-6776952,2018-12-01,2018-12-01,Healthcare
40906174,0,15782,-6761170,2018-12-01,2018-12-01,
40906174,0,479387,-6281783,2018-12-01,2018-12-01,
40906174,522436,0,-6804219,2018-12-02,2018-12-02,Education
40906174,537729,0,-7341948,2018-12-03,2018-12-03,Transportation
40906174,451826,0,-7793774,2018-12-03,2018-12-03,Clothes
40906174,0,18801,-7774973,2018-12-03,2018-12-03,
40906174,0,434685,-7340288,2018-12-04,2018-12-04,
40906174,0,664421,-6675867,2018-12-04,2018-12-04,
40906174,0,982927,-5692940,2018-12-05,2018-12-05,
40906174,583632,0,-6276572,2018-12-05,2018-12-05,Bill Sharing
40906174,0,12052,-6264520,2018-12-05,2018-12-05,
40906174,543433,0,-6807953,2018-12-06,2018-12-06,Entertainment
40906174,0,872335,-5935618,2018-12-06,2018-12-06,
40906174,0,13110,-5922508,2018-12-06,2018-12-06,
40906174,0,774685,-5147823,2018-12-07,2018-12-07,
40906174,0,662683,-4485140,2018-12-08,2018-12-08,
40906174,0,729795,-3755345,2018-12-08,2018-12-08,
40906174,0,644085,-3111260,2018-12-09,2018-12-09,
40906174,12129,0,-3123389,2018-12-10,2018-12-10,Healthcare
40906174,18382,0,-3141771,2018-12-10,2018-12-10,Clothes
40906174,0,545657,-2596114,2018-12-11,2018-12-11,
40906174,16910,0,-2613024,2018-12-11,2018-12-11,Entertainment
40906174,17164,0,-2630188,2018-12-12,2018-12-12,Groceries
40906174,0,574376,-2055812,2018-12-12,2018-12-12,
40906174,991254,0,-3047066,2018-12-12,2018-12-12,Rent
40906174,0,540657,-2506409,2018-12-13,2018-12-13,
40906174,901209,0,-3407618,2018-12-13,2018-12-13,Rent
40906174,894253,0,-2895325,2018-12-14,2018-12-14,Healthcare
40906174,0,968798,-1926527,2018-12-14,2018-12-14,
40906174,0,18618,-1907909,2018-12-14,2018-12-14,
40906174,0,13633,-1894276,2018-12-15,2018-12-15,
40906174,16841,0,-1911117,2018-12-16,2018-12-16,Clothes
40906174,440213,0,-2351330,2018-12-17,2018-12-17,Groceries
40906174,0,870358,-1480972,2018-12-18,2018-12-18,
40906174,0,18304,-1462668,2018-12-19,2018-12-19,
40906174,0,19019,-1443649,2018-12-19,2018-12-19,
40906174,0,889102,-960376,2018-12-20,2018-12-20,
40906174,0,873743,-86633,2018-12-20,2018-12-20,
40906174,0,925007,-840876,2018-12-21,2018-12-21,
40906174,600049,0,-853350,2018-12-22,2018-12-22,Education
40906174,14761,0,-868111,2018-12-22,2018-12-22,Groceries
40906174,0,648210,-219901,2018-12-23,2018-12-23,
40906174,0,406757,-186856,2018-12-23,2018-12-23,
40906174,0,600294,413438,2018-12-23,2018-12-23,
40906174,0,12889,426327,2018-12-24,2018-12-24,
40906174,0,17519,443846,2018-12-24,2018-12-24,
40906174,777342,0,-430557,2018-12-25,2018-12-25,Healthcare
40906174,955695,0,-1097805,2018-12-25,2018-12-25,Education
40906174,782056,0,-1879861,2018-12-25,2018-12-25,Healthcare
40906174,953514,0,-2833375,2018-12-26,2018-12-26,Rent
40906174,0,731001,-2102374,2018-12-27,2018-12-27,
40906174,466906,0,-2569280,2018-12-27,2018-12-27,Education
40906174,910851,0,-3480131,2018-12-28,2018-12-28,Utilities
40906174,0,10290,-3469841,2018-12-28,2018-12-28,
40906174,0,598178,-2871663,2018-12-29,2018-12-29,
40906174,835599,0,-3707262,2018-12-29,2018-12-29,Healthcare
40906174,611296,0,-4318558,2018-12-29,2018-12-29,Bill Sharing
40906174,704147,0,-5022705,2018-12-30,2018-12-30,Transportation
40906174,932570,0,-5955275,2018-12-31,2018-12-31,Entertainment
40906174,0,19363,-5935912,2018-12-31,2018-12-31,
40906174,13494,0,-5949406,2019-01-01,2019-01-01,Rent
40906174,0,10174,-5939232,2019-01-01,2019-01-01,
40906174,0,10929,-5928303,2019-01-01,2019-01-01,
40906174,967488,0,-6895791,2019-01-02,2019-01-02,Utilities
40906174,0,573580,-6322211,2019-01-02,2019-01-02,
40906174,0,908558,-5413653,2019-01-03,2019-01-03,
40906174,412875,0,-5826528,2019-01-03,2019-01-03,Healthcare
40906174,0,11925,-5814603,2019-01-03,2019-01-03,
40906174,17463,0,-5832066,2019-01-04,2019-01-04,Bill Sharing
40906174,16838,0,-5848904,2019-01-05,2019-01-05,Rent
40906174,548387,0,-6397291,2019-01-06,2019-01-06,Bill Sharing
40906174,534185,0,-6931476,2019-01-06,2019-01-06,Entertainment
40906174,0,13202,-6918274,2019-01-07,2019-01-07,
40906174,0,11649,-6906625,2019-01-07,2019-01-07,
40906174,764643,0,-7671268,2019-01-08,2019-01-08,Healthcare
40906174,629808,0,-8301076,2019-01-08,2019-01-08,Education
40906174,0,556226,-7744850,2019-01-09,2019-01-09,
40906174,0,14512,-7730338,2019-01-09,2019-01-09,
40906174,0,605758,-6933667,2019-01-10,2019-01-10,
40906174,15640,0,-6949307,2019-01-11,2019-01-11,Utilities
40906174,16160,0,-6965467,2019-01-11,2019-01-11,Groceries
40906174,15127,0,-6980594,2019-01-12,2019-01-12,Entertainment
40906174,0,926397,-6054197,2019-01-13,2019-01-13,
40906174,0,18970,-6035227,2019-01-14,2019-01-14,
40906174,15442,0,-6050669,2019-01-14,2019-01-14,Transportation
40906174,0,10216,-6040453,2019-01-14,2019-01-14,
40906174,974008,0,-7014461,2019-01-15,2019-01-15,Education
40906174,0,453793,-6560668,2019-01-16,2019-01-16,
40906174,0,543979,-6016689,2019-01-16,2019-01-16,
40906174,693000,0,-6709689,2019-01-16,2019-01-16,Healthcare
40906174,18637,0,-6728326,2019-01-17,2019-01-17,Utilities
40906174,576638,0,-7304964,2019-01-18,2019-01-18,Entertainment
40906174,800675,0,-8105639,2019-01-18,2019-01-18,Healthcare
40906174,16364,0,-8122003,2019-01-18,2019-01-18,Groceries
40906174,18306,0,-8140309,2019-01-19,2019-01-19,Transportation
40906174,0,12165,-8128144,2019-01-19,2019-01-19,
40906174,0,11347,-8116797,2019-01-20,2019-01-20,
40906174,459314,0,-8576111,2019-01-20,2019-01-20,Bill Sharing
40906174,0,11071,-8565040,2019-01-20,2019-01-20,
40906174,0,12242,-8552798,2019-01-21,2019-01-21,
40906174,514924,0,-9067722,2019-01-22,2019-01-22,Entertainment
40906174,0,12016,-9055706,2019-01-23,2019-01-23,
40906174,14079,0,-9069785,2019-01-23,2019-01-23,Rent
40906174,0,680273,-8389512,2019-01-23,2019-01-23,
40906174,16013,0,-8405525,2019-01-24,2019-01-24,Rent
40906174,830878,0,-9236403,2019-01-24,2019-01-24,Bill Sharing
40906174,17281,0,-9253684,2019-01-25,2019-01-25,Clothes
40906174,450742,0,-9704426,2019-01-25,2019-01-25,Education
40906174,438755,0,-10143181,2019-01-25,2019-01-25,Utilities
40906174,15377,0,-10158558,2019-01-26,2019-01-26,Clothes
40906174,0,17579,-10140979,2019-01-27,2019-01-27,
40906174,0,990990,-9149989,2019-01-27,2019-01-27,
40906174,776342,0,-9926331,2019-01-27,2019-01-27,Transportation
40906174,12485,0,-9938816,2019-01-28,2019-01-28,Healthcare
40906174,0,17482,-9921334,2019-01-28,2019-01-28,
40906174,12564,0,-9933898,2019-01-28,2019-01-28,Transportation
40906174,482291,0,-10416189,2019-01-29,2019-01-29,Bill Sharing
40906174,0,733367,-9682822,2019-01-30,2019-01-30,
40906174,13959,0,-9696781,2019-01-30,2019-01-30,Healthcare
40906174,18028,0,-9714809,2019-01-30,2019-01-30,Education
40906174,0,15068,-9699741,2019-01-31,2019-01-31,
40906174,10714,0,-9710455,2019-01-31,2019-01-31,Utilities
40906174,438627,0,-9697871,2019-01-31,2019-01-31,Education
40906174,920509,0,-10618380,2019-02-01,2019-02-01,Healthcare
40906174,0,448765,-10169615,2019-02-01,2019-02-01,
40906174,0,13933,-10155682,2019-02-01,2019-02-01,
40906174,0,470701,-9684981,2019-02-02,2019-02-02,
40906174,0,14024,-9670957,2019-02-02,2019-02-02,
40906174,0,11703,-9659254,2019-02-02,2019-02-02,
40906174,14008,0,-9673262,2019-02-03,2019-02-03,Utilities
40906174,0,821809,-8851453,2019-02-03,2019-02-03,
40906174,0,910105,-7941348,2019-02-04,2019-02-04,
40906174,0,443012,-7498336,2019-02-04,2019-02-04,
40906174,0,931859,-6566477,2019-02-05,2019-02-05,
40906174,0,17752,-6548725,2019-02-06,2019-02-06,
40906174,16198,0,-6564923,2019-02-07,2019-02-07,Rent
40906174,17437,0,-6582360,2019-02-08,2019-02-08,Rent
40906174,990645,0,-7573005,2019-02-09,2019-02-09,Utilities
40906174,0,511623,-7061382,2019-02-09,2019-02-09,
40906174,15875,0,-7077257,2019-02-09,2019-02-09,Clothes
40906174,15525,0,-7092782,2019-02-10,2019-02-10,Bill Sharing
40906174,0,807611,-6285171,2019-02-10,2019-02-10,
40906174,0,408281,-5876890,2019-02-11,2019-02-11,
40906174,831776,0,-6708666,2019-02-11,2019-02-11,Healthcare
40906174,12706,0,-6721372,2019-02-12,2019-02-12,Groceries
40906174,0,687902,-6033470,2019-02-12,2019-02-12,
40906174,403985,0,-6437455,2019-02-12,2019-02-12,Education
40906174,11504,0,-6448959,2019-02-13,2019-02-13,Education
40906174,14240,0,-6463199,2019-02-13,2019-02-13,Groceries
40906174,0,686845,-5776354,2019-02-14,2019-02-14,
40906174,0,15566,-5760788,2019-02-14,2019-02-14,
40906174,0,15493,-5745295,2019-02-14,2019-02-14,
40906174,0,536252,-5209043,2019-02-15,2019-02-15,
40906174,11293,0,-5220336,2019-02-15,2019-02-15,Rent
40906174,897925,0,-6118261,2019-02-16,2019-02-16,Transportation
40906174,0,934802,-5183459,2019-02-16,2019-02-16,
40906174,752669,0,-5936128,2019-02-17,2019-02-17,Healthcare
40906174,0,488485,-5447643,2019-02-17,2019-02-17,
40906174,526170,0,-5973813,2019-02-17,2019-02-17,Utilities
40906174,0,510973,-5462840,2019-02-18,2019-02-18,
40906174,0,527491,-4935349,2019-02-18,2019-02-18,
40906174,10355,0,-4945704,2019-02-18,2019-02-18,Clothes
40906174,0,646227,-4299477,2019-02-19,2019-02-19,
40906174,0,727919,-3571558,2019-02-20,2019-02-20,
40906174,13445,0,-3585003,2019-02-20,2019-02-20,Bill Sharing
40906174,12751,0,-3597754,2019-02-21,2019-02-21,Education
40906174,10480,0,-3608234,2019-02-21,2019-02-21,Groceries
40906174,595253,0,-4203487,2019-02-22,2019-02-22,Education
40906174,0,14507,-4188980,2019-02-23,2019-02-23,
40906174,12245,0,-4201225,2019-02-23,2019-02-23,Groceries
40906174,763375,0,-4964600,2019-02-23,2019-02-23,Healthcare
40906174,0,11635,-4952965,2019-02-24,2019-02-24,
40906174,548373,0,-5501338,2019-02-24,2019-02-24,Entertainment
40906174,0,931814,-4569524,2019-02-24,2019-02-24,
40906174,13126,0,-4582650,2019-02-25,2019-02-25,Transportation
40906174,14582,0,-4597232,2019-02-25,2019-02-25,Healthcare
40906174,0,665830,-3931402,2019-02-26,2019-02-26,
40906174,873475,0,-3942430,2019-02-26,2019-02-26,Education
40906174,11673,0,-3954103,2019-02-26,2019-02-26,Education
40906174,551548,0,-4817832,2019-02-27,2019-02-27,Education
40906174,827308,0,-5645140,2019-02-28,2019-02-28,Bill Sharing
40906174,929396,0,-6574536,2019-02-28,2019-02-28,Utilities
40906174,626265,0,-7200801,2019-03-01,2019-03-01,Clothes
40906174,503698,0,-7704499,2019-03-02,2019-03-02,Entertainment
40906174,0,492237,-7212262,2019-03-02,2019-03-02,
40906174,0,17522,-7194740,2019-03-03,2019-03-03,
40906174,0,513734,-6681006,2019-03-03,2019-03-03,
40906174,0,652849,-6028157,2019-03-03,2019-03-03,
40906174,575500,0,-6603657,2019-03-04,2019-03-04,Education
40906174,759693,0,-7363350,2019-03-05,2019-03-05,Healthcare
40906174,587586,0,-7950936,2019-03-05,2019-03-05,Transportation
40906174,0,614093,-7336843,2019-03-06,2019-03-06,
40906174,0,18293,-7318550,2019-03-06,2019-03-06,
40906174,0,840664,-6477886,2019-03-06,2019-03-06,
40906174,0,855853,-5622033,2019-03-07,2019-03-07,
40906174,18641,0,-5640674,2019-03-07,2019-03-07,Groceries
40906174,900992,0,-6541666,2019-03-08,2019-03-08,Rent
40906174,987221,0,-7528887,2019-03-08,2019-03-08,Transportation
40906174,0,979895,-6548992,2019-03-09,2019-03-09,
40906174,0,14802,-6534190,2019-03-09,2019-03-09,
40906174,0,650337,-5883853,2019-03-10,2019-03-10,
40906174,15838,0,-5899691,2019-03-10,2019-03-10,Transportation
40906174,0,841222,-5058469,2019-03-10,2019-03-10,
40906174,13360,0,-5071829,2019-03-11,2019-03-11,Clothes
40906174,15843,0,-5087672,2019-03-11,2019-03-11,Entertainment
40906174,13371,0,-5101043,2019-03-11,2019-03-11,Clothes
40906174,15841,0,-5116884,2019-03-12,2019-03-12,Utilities
40906174,0,13903,-5102981,2019-03-12,2019-03-12,
40906174,0,11778,-5091203,2019-03-13,2019-03-13,
40906174,13975,0,-5105178,2019-03-14,2019-03-14,Bill Sharing
40906174,532652,0,-5637830,2019-03-14,2019-03-14,Bill Sharing
40906174,0,19539,-5618291,2019-03-14,2019-03-14,
40906174,0,844583,-4773708,2019-03-15,2019-03-15,
40906174,540671,0,-5314379,2019-03-15,2019-03-15,Transportation
40906174,801178,0,-6115557,2019-03-15,2019-03-15,Rent
40906174,0,13112,-6102445,2019-03-16,2019-03-16,
40906174,754982,0,-6857427,2019-03-17,2019-03-17,Transportation
40906174,0,15499,-6841928,2019-03-17,2019-03-17,
40906174,0,498596,-6343332,2019-03-18,2019-03-18,
40906174,0,11053,-6332279,2019-03-18,2019-03-18,
40906174,0,14704,-6317575,2019-03-18,2019-03-18,
40906174,17796,0,-6335371,2019-03-19,2019-03-19,Clothes
40906174,0,708896,-5626475,2019-03-19,2019-03-19,
40906174,0,16765,-5609710,2019-03-20,2019-03-20,
40906174,824131,0,-6433841,2019-03-21,2019-03-21,Groceries
40906174,0,877328,-5556513,2019-03-21,2019-03-21,
40906174,967221,0,-6523734,2019-03-21,2019-03-21,Healthcare
40906174,998507,0,-7522241,2019-03-22,2019-03-22,Rent
40906174,0,980347,-6541894,2019-03-22,2019-03-22,
40906174,560615,0,-7102509,2019-03-23,2019-03-23,Groceries
40906174,0,13035,-7089474,2019-03-23,2019-03-23,
40906174,10510,0,-7099984,2019-03-23,2019-03-23,Utilities
40906174,0,942658,-6157326,2019-03-24,2019-03-24,
40906174,454473,0,-7081592,2019-03-25,2019-03-25,Education
40906174,0,871206,-6210386,2019-03-26,2019-03-26,
40906174,17934,0,-6228320,2019-03-27,2019-03-27,Groceries
40906174,0,914684,-5313636,2019-03-27,2019-03-27,
40906174,938334,0,-6251970,2019-03-27,2019-03-27,Entertainment
40906174,0,19965,-6232005,2019-03-28,2019-03-28,
40906174,14320,0,-6246325,2019-03-28,2019-03-28,Healthcare
40906174,0,462786,-5783539,2019-03-29,2019-03-29,
40906174,534683,0,-6318222,2019-03-29,2019-03-29,Bill Sharing
40906174,765046,0,-7083268,2019-03-30,2019-03-30,Clothes
40906174,0,927055,-6210074,2019-03-31,2019-03-31,
40906174,0,655635,-5554439,2019-04-01,2019-04-01,
40906174,0,13943,-5540496,2019-04-01,2019-04-01,
40906174,547655,0,-6088151,2019-04-02,2019-04-02,Rent
40906174,0,522031,-5566120,2019-04-02,2019-04-02,
40906174,19315,0,-5585435,2019-04-02,2019-04-02,Education
40906174,411574,0,-5997009,2019-04-03,2019-04-03,Groceries
40906174,18377,0,-6015386,2019-04-04,2019-04-04,Clothes
40906174,11928,0,-6027314,2019-04-04,2019-04-04,Bill Sharing
40906174,695788,0,-6723102,2019-04-05,2019-04-05,Groceries
40906174,0,676933,-6046169,2019-04-06,2019-04-06,
40906174,16173,0,-6062342,2019-04-07,2019-04-07,Bill Sharing
40906174,14747,0,-6077089,2019-04-08,2019-04-08,Healthcare
40906174,661837,0,-6738926,2019-04-08,2019-04-08,Entertainment
40906174,19131,0,-6758057,2019-04-09,2019-04-09,Education
40906174,0,17525,-6740532,2019-04-10,2019-04-10,
40906174,0,461386,-6279146,2019-04-10,2019-04-10,
40906174,0,533036,-6782081,2019-04-11,2019-04-11,
40906174,601214,0,-7383295,2019-04-11,2019-04-11,Entertainment
40906174,15236,0,-7398531,2019-04-12,2019-04-12,Rent
40906174,0,15754,-7382777,2019-04-12,2019-04-12,
40906174,728619,0,-8111396,2019-04-12,2019-04-12,Groceries
40906174,798183,0,-8097124,2019-04-13,2019-04-13,Education
40906174,0,936390,-7160734,2019-04-14,2019-04-14,
40906174,543191,0,-7703925,2019-04-14,2019-04-14,Education
40906174,0,797288,-6906637,2019-04-15,2019-04-15,
40906174,511408,0,-7418045,2019-04-15,2019-04-15,Clothes
40906174,0,605357,-6812688,2019-04-16,2019-04-16,
40906174,0,668741,-6143947,2019-04-16,2019-04-16,
40906174,604911,0,-6748858,2019-04-17,2019-04-17,Entertainment
40906174,0,445347,-6303511,2019-04-17,2019-04-17,
40906174,0,664103,-5639408,2019-04-17,2019-04-17,
40906174,546982,0,-6186390,2019-04-18,2019-04-18,Entertainment
40906174,0,701089,-5485301,2019-04-18,2019-04-18,
40906174,0,554361,-4930940,2019-04-18,2019-04-18,
40906174,0,11890,-4919050,2019-04-19,2019-04-19,
40906174,571161,0,-5490211,2019-04-19,2019-04-19,Entertainment
40906174,402373,0,-5892584,2019-04-20,2019-04-20,Bill Sharing
40906174,14436,0,-5907020,2019-04-21,2019-04-21,Utilities
40906174,0,12402,-5894618,2019-04-21,2019-04-21,
40906174,19385,0,-5914003,2019-04-22,2019-04-22,Entertainment
40906174,0,699155,-5214848,2019-04-23,2019-04-23,
40906174,0,13665,-5201183,2019-04-23,2019-04-23,
40906174,0,500054,-4701129,2019-04-23,2019-04-23,
40906174,0,974967,-3726162,2019-04-24,2019-04-24,
40906174,18965,0,-3745127,2019-04-24,2019-04-24,Transportation
40906174,17234,0,-3762361,2019-04-25,2019-04-25,Entertainment
40906174,807757,0,-3750765,2019-04-26,2019-04-26,Education
40906174,19566,0,-3770331,2019-04-26,2019-04-26,Entertainment
40906174,14415,0,-3784746,2019-04-27,2019-04-27,Clothes
40906174,872470,0,-4657216,2019-04-27,2019-04-27,Clothes
40906174,11957,0,-4669173,2019-04-27,2019-04-27,Clothes
40906174,0,12478,-4656695,2019-04-28,2019-04-28,
40906174,0,408320,-4248375,2019-04-28,2019-04-28,
40906174,403593,0,-4651968,2019-04-29,2019-04-29,Groceries
40906174,0,17943,-4634025,2019-04-29,2019-04-29,
40906174,0,19058,-4614967,2019-04-29,2019-04-29,
40906174,0,15698,-4599269,2019-04-30,2019-04-30,
40906174,17385,0,-4616654,2019-05-01,2019-05-01,Utilities
40906174,0,769905,-3846749,2019-05-02,2019-05-02,
40906174,0,657039,-3189710,2019-05-03,2019-05-03,
40906174,0,721790,-2467920,2019-05-03,2019-05-03,
40906174,0,18352,-2449568,2019-05-03,2019-05-03,
40906174,0,749695,-1699873,2019-05-04,2019-05-04,
40906174,0,405262,-1294611,2019-05-04,2019-05-04,
40906174,10111,0,-1304722,2019-05-04,2019-05-04,Groceries
40906174,0,621251,-683471,2019-05-05,2019-05-05,
40906174,814598,0,-185682,2019-05-06,2019-05-06,Healthcare
40906174,13327,0,-199009,2019-05-07,2019-05-07,Groceries
40906174,0,960454,-761445,2019-05-08,2019-05-08,
40906174,0,16062,-745383,2019-05-08,2019-05-08,
40906174,0,812817,67434,2019-05-08,2019-05-08,
40906174,13881,0,53553,2019-05-09,2019-05-09,Clothes
40906174,0,13096,-66649,2019-05-09,2019-05-09,
40906174,988826,0,-1055475,2019-05-09,2019-05-09,Entertainment
40906174,0,692208,-363267,2019-05-10,2019-05-10,
40906174,16387,0,-379654,2019-05-11,2019-05-11,Utilities
40906174,0,706428,-326774,2019-05-11,2019-05-11,
40906174,0,14477,-312297,2019-05-11,2019-05-11,
40906174,0,14326,-297971,2019-05-12,2019-05-12,
40906174,780842,0,-1078813,2019-05-12,2019-05-12,Clothes
40906174,0,688356,-390457,2019-05-12,2019-05-12,
40906174,0,734565,-1341034,2019-05-13,2019-05-13,
40906174,0,14682,-1326352,2019-05-13,2019-05-13,
40906174,0,883184,-443168,2019-05-13,2019-05-13,
40906174,651413,0,-1094581,2019-05-14,2019-05-14,Rent
40906174,0,17878,-1076703,2019-05-15,2019-05-15,
40906174,811140,0,-1887843,2019-05-15,2019-05-15,Bill Sharing
40906174,0,12827,-1875016,2019-05-15,2019-05-15,
40906174,0,14295,-1860721,2019-05-16,2019-05-16,
40906174,0,510582,-1350139,2019-05-17,2019-05-17,
40906174,547070,0,-1897209,2019-05-18,2019-05-18,Utilities
40906174,0,821047,-1076162,2019-05-18,2019-05-18,
40906174,0,714433,-361729,2019-05-18,2019-05-18,
40906174,0,922865,-121244,2019-05-19,2019-05-19,
40906174,0,16636,-104608,2019-05-20,2019-05-20,
40906174,0,863709,759101,2019-05-20,2019-05-20,
40906174,523382,0,235719,2019-05-21,2019-05-21,Education
40906174,17807,0,217912,2019-05-22,2019-05-22,Healthcare
40906174,0,19193,237105,2019-05-22,2019-05-22,
40906174,17239,0,-219866,2019-05-23,2019-05-23,Utilities
40906174,797904,0,-1017770,2019-05-23,2019-05-23,Utilities
40906174,916332,0,-1934102,2019-05-24,2019-05-24,Groceries
40906174,12530,0,-1946632,2019-05-24,2019-05-24,Clothes
40906174,0,10587,-1936045,2019-05-24,2019-05-24,
40906174,0,11800,-1924245,2019-05-25,2019-05-25,
40906174,555133,0,-2479378,2019-05-25,2019-05-25,Transportation
40906174,0,594840,-1884538,2019-05-25,2019-05-25,
40906174,0,619827,-1264711,2019-05-26,2019-05-26,
40906174,0,18468,-1246243,2019-05-26,2019-05-26,
40906174,0,831894,-414349,2019-05-26,2019-05-26,
40906174,960568,0,-1374917,2019-05-27,2019-05-27,Rent
40906174,550948,0,-806102,2019-05-27,2019-05-27,Healthcare
40906174,0,513280,-292822,2019-05-27,2019-05-27,
40906174,761440,0,-1054262,2019-05-28,2019-05-28,Rent
40906174,538623,0,-1592885,2019-05-28,2019-05-28,Groceries
40906174,859729,0,-2452614,2019-05-28,2019-05-28,Healthcare
40906174,494861,0,-2947475,2019-05-29,2019-05-29,Education
40906174,754760,0,-3702235,2019-05-29,2019-05-29,Clothes
40906174,0,846031,-4382154,2019-05-30,2019-05-30,
40906174,19512,0,-4401666,2019-05-30,2019-05-30,Groceries
40906174,764966,0,-5166632,2019-05-31,2019-05-31,Bill Sharing
40906174,497794,0,-5664426,2019-05-31,2019-05-31,Utilities
40906174,0,13986,-5650440,2019-05-31,2019-05-31,
40906174,0,486944,-5163496,2019-06-01,2019-06-01,
40906174,0,18595,-5144901,2019-06-02,2019-06-02,
40906174,0,901542,-4243359,2019-06-02,2019-06-02,
40906174,0,648567,-3594792,2019-06-02,2019-06-02,
40906174,0,766807,-2827985,2019-06-03,2019-06-03,
40906174,0,858410,-1969575,2019-06-03,2019-06-03,
40906174,0,18235,-1951340,2019-06-04,2019-06-04,
40906174,595621,0,-2546961,2019-06-04,2019-06-04,Utilities
40906174,0,840105,-1706856,2019-06-05,2019-06-05,
40906174,0,10040,-1696816,2019-06-05,2019-06-05,
40906174,456532,0,-2153348,2019-06-05,2019-06-05,Healthcare
40906174,0,15056,-2138292,2019-06-06,2019-06-06,
40906174,862371,0,-3000663,2019-06-07,2019-06-07,Utilities
40906174,701790,0,-3702453,2019-06-08,2019-06-08,Education
40906174,0,602354,-3100099,2019-06-09,2019-06-09,
40906174,670322,0,-3770421,2019-06-09,2019-06-09,Bill Sharing
40906174,908859,0,-4679280,2019-06-10,2019-06-10,Rent
40906174,0,483227,-4196053,2019-06-10,2019-06-10,
40906174,862769,0,-5058822,2019-06-10,2019-06-10,Groceries
40906174,14255,0,-5073077,2019-06-11,2019-06-11,Groceries
40906174,978132,0,-6051209,2019-06-11,2019-06-11,Groceries
40906174,0,18250,-6032959,2019-06-12,2019-06-12,
40906174,14027,0,-6046986,2019-06-12,2019-06-12,Clothes
40906174,0,13244,-6033742,2019-06-13,2019-06-13,
40906174,11755,0,-6045497,2019-06-13,2019-06-13,Entertainment
40906174,0,536548,-5508949,2019-06-13,2019-06-13,
40906174,0,15522,-5493427,2019-06-14,2019-06-14,
40906174,19117,0,-5512544,2019-06-14,2019-06-14,Bill Sharing
40906174,0,975156,-4537388,2019-06-14,2019-06-14,
40906174,918140,0,-5455528,2019-06-15,2019-06-15,Transportation
40906174,541430,0,-5996958,2019-06-15,2019-06-15,Groceries
40906174,0,607239,-5389719,2019-06-15,2019-06-15,
40906174,0,980960,-4408759,2019-06-16,2019-06-16,
40906174,15500,0,-4424259,2019-06-17,2019-06-17,Transportation
40906174,0,535063,-3889196,2019-06-18,2019-06-18,
40906174,0,18615,-3870581,2019-06-18,2019-06-18,
40906174,14608,0,-3885189,2019-06-19,2019-06-19,Transportation
40906174,0,15076,-3870113,2019-06-19,2019-06-19,
40906174,0,670198,-3199915,2019-06-19,2019-06-19,
40906174,13981,0,-3213896,2019-06-20,2019-06-20,Transportation
40906174,0,452706,-2761190,2019-06-21,2019-06-21,
40906174,688841,0,-3450031,2019-06-21,2019-06-21,Healthcare
40906174,0,903038,-2546993,2019-06-21,2019-06-21,
40906174,0,19628,-2527365,2019-06-22,2019-06-22,
40906174,12475,0,-2539840,2019-06-23,2019-06-23,Clothes
40906174,0,12028,-2527812,2019-06-23,2019-06-23,
40906174,0,19384,-2508428,2019-06-23,2019-06-23,
40906174,0,959384,-1549044,2019-06-24,2019-06-24,
40906174,13211,0,-1562255,2019-06-25,2019-06-25,Transportation
40906174,0,807302,-754953,2019-06-25,2019-06-25,
40906174,598269,0,-1353222,2019-06-26,2019-06-26,Clothes
40906174,15830,0,-1369052,2019-06-27,2019-06-27,Bill Sharing
40906174,979163,0,-2348215,2019-06-27,2019-06-27,Clothes
40906174,0,12411,-2335804,2019-06-28,2019-06-28,
40906174,0,453978,-1881826,2019-06-29,2019-06-29,
40906174,0,965807,-916019,2019-06-29,2019-06-29,
40906174,596533,0,-1512552,2019-06-30,2019-06-30,Education
40906174,606867,0,-2119419,2019-07-01,2019-07-01,Healthcare
40906174,0,422333,-3042036,2019-07-01,2019-07-01,
40906174,800667,0,-3842703,2019-07-02,2019-07-02,Rent
40906174,0,17495,-3825208,2019-07-02,2019-07-02,
40906174,786434,0,-4611642,2019-07-03,2019-07-03,Education
40906174,512780,0,-5124422,2019-07-03,2019-07-03,Utilities
40906174,0,987709,-4136713,2019-07-04,2019-07-04,
40906174,674069,0,-4810782,2019-07-05,2019-07-05,Entertainment
40906174,422641,0,-5233423,2019-07-05,2019-07-05,Rent
40906174,0,16442,-5216981,2019-07-05,2019-07-05,
40906174,0,18629,-5198352,2019-07-06,2019-07-06,
40906174,0,430895,-4767457,2019-07-06,2019-07-06,
40906174,12056,0,-4779513,2019-07-06,2019-07-06,Utilities
40906174,0,408939,-4370574,2019-07-07,2019-07-07,
40906174,701343,0,-4909264,2019-07-07,2019-07-07,Education
40906174,0,820771,-4088493,2019-07-08,2019-07-08,
40906174,12818,0,-4101311,2019-07-09,2019-07-09,Groceries
40906174,15705,0,-4117016,2019-07-09,2019-07-09,Groceries
40906174,0,964502,-3152514,2019-07-10,2019-07-10,
40906174,928058,0,-4080572,2019-07-10,2019-07-10,Rent
40906174,0,18750,-4061822,2019-07-11,2019-07-11,
40906174,454336,0,-4516158,2019-07-11,2019-07-11,Bill Sharing
40906174,0,18964,-4497194,2019-07-11,2019-07-11,
40906174,0,545970,-3951224,2019-07-12,2019-07-12,
40906174,0,13166,-3938058,2019-07-12,2019-07-12,
40906174,550159,0,-4488217,2019-07-13,2019-07-13,Bill Sharing
40906174,0,458196,-4030021,2019-07-13,2019-07-13,
40906174,0,911786,-3118235,2019-07-14,2019-07-14,
40906174,0,570895,-2547340,2019-07-14,2019-07-14,
40906174,16145,0,-2563485,2019-07-15,2019-07-15,Rent
40906174,584790,0,-3148275,2019-07-15,2019-07-15,Groceries
40906174,0,452001,-2696274,2019-07-16,2019-07-16,
40906174,11918,0,-2708192,2019-07-16,2019-07-16,Healthcare
40906174,0,616983,-2091209,2019-07-17,2019-07-17,
40906174,805464,0,-2896673,2019-07-18,2019-07-18,Clothes
40906174,0,13827,-2882846,2019-07-18,2019-07-18,
40906174,490741,0,-3373587,2019-07-19,2019-07-19,Healthcare
40906174,773753,0,-4147340,2019-07-20,2019-07-20,Healthcare
40906174,832495,0,-4979835,2019-07-20,2019-07-20,Groceries
40906174,12828,0,-4992663,2019-07-20,2019-07-20,Utilities
40906174,0,12682,-4979981,2019-07-21,2019-07-21,
40906174,0,16546,-4963435,2019-07-21,2019-07-21,
40906174,0,15364,-4948071,2019-07-21,2019-07-21,
40906174,0,19094,-4928977,2019-07-22,2019-07-22,
40906174,977880,0,-5906857,2019-07-22,2019-07-22,Transportation
40906174,18369,0,-5925226,2019-07-22,2019-07-22,Groceries
40906174,473402,0,-6398628,2019-07-23,2019-07-23,Rent
40906174,663885,0,-7062513,2019-07-23,2019-07-23,Utilities
40906174,992251,0,-8054764,2019-07-24,2019-07-24,Transportation
40906174,0,798521,-7256243,2019-07-24,2019-07-24,
40906174,559639,0,-7815882,2019-07-24,2019-07-24,Entertainment
40906174,615045,0,-8430927,2019-07-25,2019-07-25,Groceries
40906174,0,11631,-8419296,2019-07-25,2019-07-25,
40906174,0,19511,-8399785,2019-07-26,2019-07-26,
40906174,907386,0,-9307171,2019-07-26,2019-07-26,Utilities
40906174,0,10041,-9297130,2019-07-26,2019-07-26,
40906174,0,774805,-8522325,2019-07-27,2019-07-27,
40906174,0,404390,-8117935,2019-07-28,2019-07-28,
40906174,973921,0,-9091856,2019-07-28,2019-07-28,Clothes
40906174,959190,0,-10051046,2019-07-29,2019-07-29,Entertainment
40906174,0,882494,-9168552,2019-07-30,2019-07-30,
40906174,0,944678,-8223874,2019-07-30,2019-07-30,
40906174,0,845364,-7334654,2019-07-30,2019-07-30,
40906174,0,14864,-7319790,2019-07-31,2019-07-31,
40906174,0,17169,-7302621,2019-07-31,2019-07-31,
40906174,0,510719,-6791902,2019-08-01,2019-08-01,
40906174,463878,0,-7255780,2019-08-01,2019-08-01,Utilities
40906174,16354,0,-7272134,2019-08-01,2019-08-01,Education
40906174,854711,0,-8126845,2019-08-02,2019-08-02,Healthcare
40906174,699007,0,-8825852,2019-08-02,2019-08-02,Healthcare
40906174,0,12697,-8813155,2019-08-03,2019-08-03,
40906174,0,512528,-8300627,2019-08-03,2019-08-03,
40906174,888066,0,-9188693,2019-08-03,2019-08-03,Utilities
40906174,822065,0,-10010758,2019-08-04,2019-08-04,Bill Sharing
40906174,0,696499,-9314259,2019-08-04,2019-08-04,
40906174,0,885867,-9331564,2019-08-05,2019-08-05,
40906174,0,401101,-8930463,2019-08-05,2019-08-05,
40906174,11871,0,-8942334,2019-08-05,2019-08-05,Clothes
40906174,17479,0,-8959813,2019-08-06,2019-08-06,Transportation
40906174,639588,0,-9599401,2019-08-06,2019-08-06,Bill Sharing
40906174,0,863111,-8736290,2019-08-07,2019-08-07,
40906174,17078,0,-8753368,2019-08-07,2019-08-07,Healthcare
40906174,816092,0,-9569460,2019-08-07,2019-08-07,Groceries
40906174,471692,0,-10041152,2019-08-08,2019-08-08,Bill Sharing
40906174,517334,0,-10558486,2019-08-08,2019-08-08,Healthcare
40906174,0,948986,-9609500,2019-08-08,2019-08-08,
40906174,18443,0,-9627943,2019-08-09,2019-08-09,Transportation
40906174,0,478081,-9149862,2019-08-09,2019-08-09,
40906174,0,10493,-9139369,2019-08-10,2019-08-10,
40906174,0,541477,-8597892,2019-08-10,2019-08-10,
40906174,0,19732,-8578160,2019-08-10,2019-08-10,
40906174,17200,0,-8595360,2019-08-11,2019-08-11,Education
40906174,10129,0,-8605489,2019-08-11,2019-08-11,Clothes
40906174,10901,0,-8616390,2019-08-12,2019-08-12,Utilities
40906174,0,952156,-7664234,2019-08-12,2019-08-12,
40906174,13814,0,-7678048,2019-08-13,2019-08-13,Rent
40906174,456842,0,-8134890,2019-08-13,2019-08-13,Education
40906174,0,875019,-7259871,2019-08-14,2019-08-14,
40906174,0,450948,-6808923,2019-08-14,2019-08-14,
40906174,10683,0,-6819606,2019-08-14,2019-08-14,Healthcare
40906174,0,12639,-6806967,2019-08-15,2019-08-15,
40906174,12155,0,-6819122,2019-08-16,2019-08-16,Groceries
40906174,819699,0,-7638821,2019-08-17,2019-08-17,Utilities
40906174,0,899103,-6739718,2019-08-18,2019-08-18,
40906174,898772,0,-7638490,2019-08-19,2019-08-19,Groceries
40906174,14855,0,-7653345,2019-08-20,2019-08-20,Clothes
40906174,0,19164,-7634181,2019-08-20,2019-08-20,
40906174,14306,0,-7648487,2019-08-21,2019-08-21,Groceries
40906174,627156,0,-8275643,2019-08-21,2019-08-21,Entertainment
40906174,0,905230,-7780942,2019-08-22,2019-08-22,
40906174,0,701626,-7079316,2019-08-23,2019-08-23,
40906174,0,15661,-7063655,2019-08-24,2019-08-24,
40906174,14590,0,-7078245,2019-08-24,2019-08-24,Rent
40906174,16702,0,-7094947,2019-08-25,2019-08-25,Healthcare
40906174,508688,0,-7603635,2019-08-26,2019-08-26,Transportation
40906174,508844,0,-8112479,2019-08-26,2019-08-26,Groceries
40906174,756536,0,-8869015,2019-08-26,2019-08-26,Groceries
40906174,0,12894,-8856121,2019-08-27,2019-08-27,
40906174,0,512740,-8343381,2019-08-27,2019-08-27,
40906174,985931,0,-9329312,2019-08-27,2019-08-27,Groceries
40906174,407650,0,-9736962,2019-08-28,2019-08-28,Clothes
40906174,755206,0,-10492168,2019-08-28,2019-08-28,Utilities
40906174,0,411805,-10080363,2019-08-28,2019-08-28,
40906174,0,14657,-10065706,2019-08-29,2019-08-29,
40906174,447721,0,-10513427,2019-08-29,2019-08-29,Transportation
40906174,17570,0,-10530997,2019-08-29,2019-08-29,Education
40906174,690548,0,-11221545,2019-08-30,2019-08-30,Groceries
40906174,818236,0,-12039781,2019-08-31,2019-08-31,Bill Sharing
40906174,17826,0,-12057607,2019-09-01,2019-09-01,Utilities
40906174,700881,0,-12758488,2019-09-02,2019-09-02,Utilities
40906174,0,12204,-12746284,2019-09-02,2019-09-02,
40906174,736792,0,-13483076,2019-09-02,2019-09-02,Healthcare
40906174,18427,0,-13501503,2019-09-03,2019-09-03,Bill Sharing
40906174,0,466426,-13035077,2019-09-03,2019-09-03,
40906174,0,743453,-12291624,2019-09-04,2019-09-04,
40906174,0,474289,-11817335,2019-09-04,2019-09-04,
40906174,792106,0,-12609441,2019-09-05,2019-09-05,Education
40906174,807328,0,-13416769,2019-09-05,2019-09-05,Bill Sharing
40906174,0,520422,-12896347,2019-09-06,2019-09-06,
40906174,680536,0,-13685265,2019-09-06,2019-09-06,Education
40906174,0,941681,-12743584,2019-09-07,2019-09-07,
40906174,553617,0,-13297201,2019-09-07,2019-09-07,Groceries
40906174,581898,0,-13879099,2019-09-07,2019-09-07,Entertainment
40906174,907199,0,-14786298,2019-09-08,2019-09-08,Bill Sharing
40906174,0,574721,-14211577,2019-09-08,2019-09-08,
40906174,0,15140,-14196437,2019-09-09,2019-09-09,
40906174,0,18705,-14177732,2019-09-09,2019-09-09,
40906174,17911,0,-14195643,2019-09-09,2019-09-09,Clothes
40906174,0,16269,-14179374,2019-09-10,2019-09-10,
40906174,0,957692,-13221682,2019-09-10,2019-09-10,
40906174,11315,0,-13232997,2019-09-11,2019-09-11,Healthcare
40906174,0,881532,-12351465,2019-09-12,2019-09-12,
40906174,0,422080,-11929385,2019-09-12,2019-09-12,
40906174,0,11488,-11917897,2019-09-13,2019-09-13,
40906174,10512,0,-11928409,2019-09-14,2019-09-14,Rent
40906174,675023,0,-12603432,2019-09-14,2019-09-14,Groceries
40906174,0,692881,-12133313,2019-09-15,2019-09-15,
40906174,0,445479,-11687834,2019-09-15,2019-09-15,
40906174,479472,0,-12167306,2019-09-15,2019-09-15,Groceries
40906174,896907,0,-13064213,2019-09-16,2019-09-16,Utilities
40906174,0,11078,-13053135,2019-09-17,2019-09-17,
40906174,15883,0,-13069018,2019-09-17,2019-09-17,Transportation
40906174,0,693171,-12375847,2019-09-17,2019-09-17,
40906174,0,16868,-12358979,2019-09-18,2019-09-18,
40906174,928084,0,-13287063,2019-09-18,2019-09-18,Entertainment
40906174,555943,0,-13843006,2019-09-19,2019-09-19,Bill Sharing
40906174,0,13315,-13829691,2019-09-19,2019-09-19,
40906174,0,821545,-13008146,2019-09-20,2019-09-20,
40906174,559154,0,-13567300,2019-09-20,2019-09-20,Transportation
40906174,16335,0,-13583635,2019-09-20,2019-09-20,Education
40906174,0,438609,-13145026,2019-09-21,2019-09-21,
40906174,765468,0,-13910494,2019-09-22,2019-09-22,Transportation
40906174,0,10692,-13899802,2019-09-23,2019-09-23,
40906174,0,18080,-13881722,2019-09-23,2019-09-23,
40906174,18228,0,-13899950,2019-09-23,2019-09-23,Utilities
40906174,13300,0,-13913250,2019-09-24,2019-09-24,Entertainment
40906174,442497,0,-14355747,2019-09-24,2019-09-24,Clothes
40906174,0,11881,-14343866,2019-09-25,2019-09-25,
40906174,0,936776,-13407090,2019-09-25,2019-09-25,
40906174,0,879686,-12527404,2019-09-26,2019-09-26,
40906174,455211,0,-12982615,2019-09-26,2019-09-26,Education
40906174,0,16795,-12965820,2019-09-26,2019-09-26,
40906174,840859,0,-13806679,2019-09-27,2019-09-27,Bill Sharing
40906174,507335,0,-14314014,2019-09-27,2019-09-27,Healthcare
40906174,0,10577,-14303437,2019-09-27,2019-09-27,
40906174,0,850999,-13452438,2019-09-28,2019-09-28,
40906174,465802,0,-13918240,2019-09-28,2019-09-28,Education
40906174,764563,0,-14682803,2019-09-29,2019-09-29,Transportation
40906174,0,19143,-14663660,2019-09-30,2019-09-30,
40906174,516907,0,-15180567,2019-10-01,2019-10-01,Rent
40906174,608142,0,-15788709,2019-10-01,2019-10-01,Groceries
40906174,0,686262,-15102447,2019-10-01,2019-10-01,
40906174,0,12589,-15089858,2019-10-02,2019-10-02,
40906174,17867,0,-15107725,2019-10-02,2019-10-02,Utilities
40906174,0,433610,-14674115,2019-10-02,2019-10-02,
40906174,0,617663,-14056452,2019-10-03,2019-10-03,
40906174,0,15456,-14040996,2019-10-04,2019-10-04,
40906174,0,19502,-14021494,2019-10-04,2019-10-04,
40906174,887994,0,-14909488,2019-10-05,2019-10-05,Clothes
40906174,0,572063,-14337425,2019-10-06,2019-10-06,
40906174,0,752669,-13584756,2019-10-06,2019-10-06,
40906174,15178,0,-13599934,2019-10-07,2019-10-07,Education
40906174,0,733944,-12865990,2019-10-07,2019-10-07,
40906174,0,11472,-12854518,2019-10-08,2019-10-08,
40906174,0,10526,-12843992,2019-10-09,2019-10-09,
40906174,0,10850,-12833142,2019-10-10,2019-10-10,
40906174,19936,0,-12853078,2019-10-10,2019-10-10,Groceries
40906174,0,662214,-12190864,2019-10-11,2019-10-11,
40906174,924134,0,-13114998,2019-10-11,2019-10-11,Clothes
40906174,849594,0,-13964592,2019-10-12,2019-10-12,Entertainment
40906174,0,406997,-13557595,2019-10-13,2019-10-13,
40906174,0,440685,-13116910,2019-10-13,2019-10-13,
40906174,675416,0,-13792326,2019-10-14,2019-10-14,Healthcare
40906174,0,760750,-13031576,2019-10-14,2019-10-14,
40906174,0,12574,-13019002,2019-10-15,2019-10-15,
40906174,18730,0,-13037732,2019-10-15,2019-10-15,Groceries
40906174,18724,0,-13056456,2019-10-15,2019-10-15,Utilities
40906174,0,909538,-12146918,2019-10-16,2019-10-16,
40906174,15106,0,-12162024,2019-10-17,2019-10-17,Healthcare
40906174,0,13301,-12148723,2019-10-17,2019-10-17,
40906174,693576,0,-12842299,2019-10-17,2019-10-17,Healthcare
40906174,12354,0,-12854653,2019-10-18,2019-10-18,Clothes
40906174,0,811717,-12042936,2019-10-18,2019-10-18,
40906174,868520,0,-12911456,2019-10-19,2019-10-19,Clothes
40906174,0,759377,-12152079,2019-10-19,2019-10-19,
40906174,634637,0,-12786716,2019-10-19,2019-10-19,Utilities
40906174,14283,0,-12800999,2019-10-20,2019-10-20,Transportation
40906174,0,13180,-12787819,2019-10-20,2019-10-20,
40906174,751821,0,-13539640,2019-10-20,2019-10-20,Rent
40906174,818054,0,-14357694,2019-10-21,2019-10-21,Clothes
40906174,12018,0,-14369712,2019-10-21,2019-10-21,Healthcare
40906174,0,913536,-13456176,2019-10-22,2019-10-22,
40906174,0,961579,-12494597,2019-10-23,2019-10-23,
40906174,0,665823,-12036532,2019-10-23,2019-10-23,
40906174,15160,0,-12051692,2019-10-23,2019-10-23,Healthcare
40906174,0,11564,-12040128,2019-10-24,2019-10-24,
40906174,750859,0,-12790987,2019-10-25,2019-10-25,Transportation
40906174,0,850653,-11940334,2019-10-25,2019-10-25,
40906174,0,15762,-11924572,2019-10-26,2019-10-26,
40906174,18000,0,-11942572,2019-10-26,2019-10-26,Transportation
40906174,0,16092,-11926480,2019-10-26,2019-10-26,
40906174,738018,0,-12664498,2019-10-27,2019-10-27,Healthcare
40906174,426029,0,-13090527,2019-10-27,2019-10-27,Bill Sharing
40906174,15898,0,-13106425,2019-10-28,2019-10-28,Transportation
40906174,0,696643,-12409782,2019-10-29,2019-10-29,
40906174,570149,0,-12979931,2019-10-30,2019-10-30,Entertainment
40906174,0,13669,-12966262,2019-10-30,2019-10-30,
40906174,0,835718,-12042136,2019-10-30,2019-10-30,
40906174,0,17720,-12024416,2019-10-31,2019-10-31,
40906174,12385,0,-12036801,2019-10-31,2019-10-31,Entertainment
40906174,0,982750,-11054051,2019-11-01,2019-11-01,
40906174,0,18039,-11036012,2019-11-01,2019-11-01,
40906174,0,825394,-10210618,2019-11-02,2019-11-02,
40906174,0,436434,-9774184,2019-11-02,2019-11-02,
40906174,11448,0,-9785632,2019-11-03,2019-11-03,Utilities
40906174,0,897748,-8887884,2019-11-04,2019-11-04,
40906174,12835,0,-8900719,2019-11-05,2019-11-05,Clothes
40906174,532797,0,-9433516,2019-11-05,2019-11-05,Healthcare
40906174,454657,0,-9888173,2019-11-06,2019-11-06,Healthcare
40906174,692399,0,-10580572,2019-11-06,2019-11-06,Utilities
40906174,0,722719,-9857853,2019-11-07,2019-11-07,
40906174,0,15706,-9842147,2019-11-07,2019-11-07,
40906174,765110,0,-10607257,2019-11-08,2019-11-08,Transportation
40906174,0,881626,-9725631,2019-11-08,2019-11-08,
40906174,720920,0,-10446551,2019-11-08,2019-11-08,Rent
40906174,667390,0,-11113941,2019-11-09,2019-11-09,Utilities
40906174,456484,0,-11570425,2019-11-09,2019-11-09,Groceries
40906174,0,614147,-10956278,2019-11-09,2019-11-09,
40906174,0,438923,-10517355,2019-11-10,2019-11-10,
40906174,0,991965,-9525390,2019-11-11,2019-11-11,
40906174,0,19821,-9505569,2019-11-12,2019-11-12,
40906174,19638,0,-9525207,2019-11-13,2019-11-13,Bill Sharing
40906174,0,872559,-8652648,2019-11-14,2019-11-14,
40906174,643658,0,-9296306,2019-11-14,2019-11-14,Bill Sharing
40906174,969916,0,-10266222,2019-11-15,2019-11-15,Transportation
40906174,492091,0,-10758313,2019-11-15,2019-11-15,Bill Sharing
40906174,0,686282,-9766362,2019-11-15,2019-11-15,
40906174,722831,0,-10489193,2019-11-16,2019-11-16,Entertainment
40906174,0,596290,-9892903,2019-11-17,2019-11-17,
40906174,445740,0,-10338643,2019-11-18,2019-11-18,Healthcare
40906174,0,977803,-9360840,2019-11-19,2019-11-19,
40906174,0,857642,-8503198,2019-11-19,2019-11-19,
40906174,0,16654,-8486544,2019-11-19,2019-11-19,
40906174,12190,0,-8498734,2019-11-20,2019-11-20,Bill Sharing
40906174,0,796983,-7701751,2019-11-20,2019-11-20,
40906174,0,12200,-7689551,2019-11-21,2019-11-21,
40906174,0,913725,-6775826,2019-11-22,2019-11-22,
40906174,511426,0,-7287252,2019-11-22,2019-11-22,Healthcare
40906174,15120,0,-7302372,2019-11-22,2019-11-22,Groceries
40906174,0,464382,-7313481,2019-11-23,2019-11-23,
40906174,17597,0,-7331078,2019-11-23,2019-11-23,Entertainment
40906174,0,10285,-7320793,2019-11-24,2019-11-24,
40906174,461904,0,-7782697,2019-11-24,2019-11-24,Entertainment
40906174,476949,0,-8259646,2019-11-24,2019-11-24,Education
40906174,0,664467,-7595179,2019-11-25,2019-11-25,
40906174,13367,0,-7608546,2019-11-25,2019-11-25,Utilities
40906174,0,987968,-6620578,2019-11-25,2019-11-25,
40906174,0,19562,-6601016,2019-11-26,2019-11-26,
40906174,10838,0,-6611854,2019-11-26,2019-11-26,Healthcare
40906174,0,10189,-6601665,2019-11-26,2019-11-26,
40906174,0,415327,-6186338,2019-11-27,2019-11-27,
40906174,0,839945,-5346393,2019-11-28,2019-11-28,
40906174,0,11875,-5334518,2019-11-28,2019-11-28,
40906174,0,15846,-5318672,2019-11-28,2019-11-28,
40906174,730257,0,-6048929,2019-11-29,2019-11-29,Education
40906174,414427,0,-6463356,2019-11-29,2019-11-29,Clothes
40906174,803660,0,-7267016,2019-11-29,2019-11-29,Education
40906174,11776,0,-7278792,2019-11-30,2019-11-30,Clothes
40906174,978705,0,-8257497,2019-12-01,2019-12-01,Rent
40906174,0,955757,-7301740,2019-12-01,2019-12-01,
40906174,851751,0,-8153491,2019-12-02,2019-12-02,Utilities
40906174,0,934915,-7218576,2019-12-02,2019-12-02,
40906174,535534,0,-7754110,2019-12-03,2019-12-03,Bill Sharing
40906174,13102,0,-7767212,2019-12-04,2019-12-04,Entertainment
40906174,0,19835,-7747377,2019-12-04,2019-12-04,
40906174,566699,0,-8314076,2019-12-04,2019-12-04,Rent
40906174,991528,0,-9305604,2019-12-05,2019-12-05,Utilities
40906174,0,427407,-8878197,2019-12-06,2019-12-06,
40906174,0,15916,-8862281,2019-12-07,2019-12-07,
40906174,0,981635,-7880646,2019-12-07,2019-12-07,
40906174,0,10376,-7870270,2019-12-08,2019-12-08,
40906174,0,16546,-7853724,2019-12-08,2019-12-08,
40906174,0,12206,-7841518,2019-12-08,2019-12-08,
40906174,666316,0,-8507834,2019-12-09,2019-12-09,Utilities
40906174,14047,0,-8521881,2019-12-10,2019-12-10,Transportation
40906174,0,15016,-8506865,2019-12-10,2019-12-10,
40906174,491687,0,-8998552,2019-12-10,2019-12-10,Utilities
40906174,0,15230,-8983322,2019-12-11,2019-12-11,
40906174,959972,0,-9943294,2019-12-11,2019-12-11,Transportation
40906174,835642,0,-10778936,2019-12-11,2019-12-11,Education
40906174,15725,0,-10794661,2019-12-12,2019-12-12,Rent
40906174,966368,0,-11761029,2019-12-13,2019-12-13,Entertainment
40906174,0,12613,-11748416,2019-12-13,2019-12-13,
40906174,412681,0,-12161097,2019-12-13,2019-12-13,Transportation
40906174,19387,0,-12180484,2019-12-14,2019-12-14,Rent
40906174,0,13260,-12167224,2019-12-14,2019-12-14,
40906174,0,960983,-11578027,2019-12-15,2019-12-15,
40906174,0,14449,-11563578,2019-12-16,2019-12-16,
40906174,16926,0,-11580504,2019-12-16,2019-12-16,Groceries
40906174,14451,0,-11594955,2019-12-17,2019-12-17,Rent
40906174,0,13195,-11581760,2019-12-17,2019-12-17,
40906174,10729,0,-11592489,2019-12-17,2019-12-17,Transportation
40906174,10908,0,-11603397,2019-12-18,2019-12-18,Transportation
40906174,0,15253,-11588144,2019-12-18,2019-12-18,
40906174,0,873932,-10714212,2019-12-19,2019-12-19,
40906174,0,554291,-10159921,2019-12-20,2019-12-20,
40906174,0,590667,-9569254,2019-12-20,2019-12-20,
40906174,0,11717,-9557537,2019-12-21,2019-12-21,
40906174,0,959028,-8598509,2019-12-21,2019-12-21,
40906174,18010,0,-8616519,2019-12-21,2019-12-21,Rent
40906174,19981,0,-8636500,2019-12-22,2019-12-22,Transportation
40906174,0,986832,-8203561,2019-12-22,2019-12-22,
40906174,854740,0,-9058301,2019-12-23,2019-12-23,Groceries
40906174,0,13130,-9045171,2019-12-24,2019-12-24,
40906174,0,14163,-9031008,2019-12-24,2019-12-24,
40906174,628864,0,-9659872,2019-12-25,2019-12-25,Bill Sharing
40906174,747469,0,-10407341,2019-12-25,2019-12-25,Clothes
40906174,0,649702,-9757639,2019-12-26,2019-12-26,
40906174,427016,0,-10184655,2019-12-26,2019-12-26,Utilities
40906174,0,14531,-10170124,2019-12-26,2019-12-26,
40906174,0,10773,-10159351,2019-12-27,2019-12-27,
40906174,18492,0,-10177843,2019-12-27,2019-12-27,Utilities
40906174,0,500102,-9677741,2019-12-28,2019-12-28,
40906174,0,507635,-9170106,2019-12-28,2019-12-28,
40906174,831851,0,-10001957,2019-12-29,2019-12-29,Entertainment
40906174,935813,0,-10937770,2019-12-30,2019-12-30,Education
40906174,969607,0,-11907377,2019-12-30,2019-12-30,Bill Sharing
40906174,713497,0,-12620874,2019-12-30,2019-12-30,Utilities
40906174,516289,0,-12605857,2019-12-31,2019-12-31,Education
40906174,16870,0,-12622727,2019-12-31,2019-12-31,Bill Sharing
40906174,426642,0,-13236268,2020-01-01,2020-01-01,Healthcare
40906174,0,11983,-13224285,2020-01-02,2020-01-02,
40906174,0,16046,-13208239,2020-01-03,2020-01-03,
40906174,744496,0,-13952735,2020-01-03,2020-01-03,Healthcare
40906174,0,740084,-13212651,2020-01-04,2020-01-04,
40906174,14633,0,-13227284,2020-01-05,2020-01-05,Education
40906174,0,737864,-12489420,2020-01-06,2020-01-06,
40906174,0,15238,-12474182,2020-01-07,2020-01-07,
40906174,0,780282,-11693900,2020-01-08,2020-01-08,
40906174,499770,0,-12193670,2020-01-08,2020-01-08,Education
40906174,459202,0,-12652872,2020-01-08,2020-01-08,Education
40906174,11921,0,-12664793,2020-01-09,2020-01-09,Healthcare
40906174,0,421533,-12243260,2020-01-09,2020-01-09,
40906174,19443,0,-12262703,2020-01-10,2020-01-10,Healthcare
40906174,573733,0,-12836436,2020-01-11,2020-01-11,Utilities
40906174,0,685841,-12150595,2020-01-11,2020-01-11,
40906174,0,19088,-12131507,2020-01-11,2020-01-11,
40906174,0,600272,-11531235,2020-01-12,2020-01-12,
40906174,0,13848,-11517387,2020-01-12,2020-01-12,
40906174,988314,0,-12505701,2020-01-12,2020-01-12,Bill Sharing
40906174,18150,0,-12523851,2020-01-13,2020-01-13,Utilities
40906174,0,888177,-11635674,2020-01-14,2020-01-14,
40906174,0,885609,-12558380,2020-01-15,2020-01-15,
40906174,12386,0,-12570766,2020-01-15,2020-01-15,Transportation
40906174,641326,0,-13212092,2020-01-16,2020-01-16,Bill Sharing
40906174,0,13427,-13198665,2020-01-17,2020-01-17,
40906174,0,11897,-13186768,2020-01-17,2020-01-17,
40906174,0,773958,-12412810,2020-01-18,2020-01-18,
40906174,801668,0,-13214478,2020-01-19,2020-01-19,Transportation
40906174,0,17568,-13196910,2020-01-19,2020-01-19,
40906174,0,965032,-12231878,2020-01-19,2020-01-19,
40906174,0,10433,-12221445,2020-01-20,2020-01-20,
40906174,0,559431,-11662014,2020-01-20,2020-01-20,
40906174,15475,0,-11677489,2020-01-20,2020-01-20,Rent
40906174,638926,0,-12316415,2020-01-21,2020-01-21,Clothes
40906174,0,11817,-12304598,2020-01-22,2020-01-22,
40906174,16975,0,-12321573,2020-01-23,2020-01-23,Groceries
40906174,923796,0,-13245369,2020-01-23,2020-01-23,Groceries
40906174,511473,0,-13756842,2020-01-24,2020-01-24,Rent
40906174,0,579779,-13177063,2020-01-25,2020-01-25,
40906174,0,554545,-12622518,2020-01-25,2020-01-25,
40906174,0,17322,-12605196,2020-01-25,2020-01-25,
40906174,11246,0,-12616442,2020-01-26,2020-01-26,Clothes
40906174,0,607247,-12009195,2020-01-27,2020-01-27,
40906174,0,651743,-11357452,2020-01-28,2020-01-28,
40906174,687059,0,-12044511,2020-01-28,2020-01-28,Transportation
40906174,0,690125,-11354386,2020-01-29,2020-01-29,
40906174,408823,0,-11763209,2020-01-29,2020-01-29,Clothes
40906174,0,18392,-11744817,2020-01-29,2020-01-29,
40906174,0,910809,-10834008,2020-01-30,2020-01-30,
40906174,721399,0,-11555407,2020-01-31,2020-01-31,Transportation
40906174,618621,0,-12174028,2020-02-01,2020-02-01,Education
40906174,0,871696,-11302332,2020-02-02,2020-02-02,
40906174,0,838106,-10464226,2020-02-02,2020-02-02,
40906174,0,14825,-10449401,2020-02-02,2020-02-02,
40906174,0,577701,-9871700,2020-02-03,2020-02-03,
40906174,10917,0,-9882617,2020-02-03,2020-02-03,Groceries
40906174,13668,0,-9896285,2020-02-04,2020-02-04,Bill Sharing
40906174,0,830275,-9066010,2020-02-05,2020-02-05,
40906174,18302,0,-9084312,2020-02-05,2020-02-05,Clothes
40906174,890552,0,-9974864,2020-02-05,2020-02-05,Healthcare
40906174,0,15904,-9958960,2020-02-06,2020-02-06,
40906174,0,456392,-9502568,2020-02-06,2020-02-06,
40906174,899742,0,-10402310,2020-02-06,2020-02-06,Groceries
40906174,14205,0,-10416515,2020-02-07,2020-02-07,Rent
40906174,565986,0,-10982501,2020-02-07,2020-02-07,Transportation
40906174,15999,0,-10998500,2020-02-08,2020-02-08,Education
40906174,15468,0,-11013968,2020-02-08,2020-02-08,Entertainment
40906174,677581,0,-11691549,2020-02-08,2020-02-08,Rent
40906174,0,415474,-11276075,2020-02-09,2020-02-09,
40906174,0,442748,-10833327,2020-02-09,2020-02-09,
40906174,428331,0,-11261658,2020-02-09,2020-02-09,Groceries
40906174,454655,0,-11716313,2020-02-10,2020-02-10,Utilities
40906174,15553,0,-11731866,2020-02-10,2020-02-10,Groceries
40906174,0,789445,-10942421,2020-02-10,2020-02-10,
40906174,0,18148,-10924273,2020-02-11,2020-02-11,
40906174,997150,0,-11921423,2020-02-11,2020-02-11,Transportation
40906174,0,494125,-11427298,2020-02-12,2020-02-12,
40906174,528887,0,-11956185,2020-02-12,2020-02-12,Transportation
40906174,0,696206,-11259979,2020-02-13,2020-02-13,
40906174,0,872921,-10387058,2020-02-14,2020-02-14,
40906174,481722,0,-10868780,2020-02-15,2020-02-15,Healthcare
40906174,833681,0,-11702461,2020-02-15,2020-02-15,Bill Sharing
40906174,0,17779,-11684682,2020-02-16,2020-02-16,
40906174,639278,0,-12323960,2020-02-16,2020-02-16,Healthcare
40906174,0,848791,-11475169,2020-02-17,2020-02-17,
40906174,0,18995,-11456174,2020-02-17,2020-02-17,
40906174,0,14684,-11441490,2020-02-18,2020-02-18,
40906174,0,528694,-10912796,2020-02-18,2020-02-18,
40906174,13168,0,-10925964,2020-02-18,2020-02-18,Education
40906174,0,19454,-10906510,2020-02-19,2020-02-19,
40906174,0,13151,-10893359,2020-02-19,2020-02-19,
40906174,524793,0,-11418152,2020-02-20,2020-02-20,Education
40906174,0,933409,-10484743,2020-02-21,2020-02-21,
40906174,413258,0,-10898001,2020-02-21,2020-02-21,Clothes
40906174,0,785356,-10112645,2020-02-22,2020-02-22,
40906174,0,18127,-10094518,2020-02-22,2020-02-22,
40906174,10051,0,-10104569,2020-02-22,2020-02-22,Bill Sharing
40906174,472600,0,-10577169,2020-02-23,2020-02-23,Education
40906174,0,542787,-10034382,2020-02-23,2020-02-23,
40906174,988310,0,-11022692,2020-02-23,2020-02-23,Entertainment
40906174,661069,0,-11683761,2020-02-24,2020-02-24,Utilities
40906174,19474,0,-11703235,2020-02-24,2020-02-24,Groceries
40906174,0,14336,-11688899,2020-02-24,2020-02-24,
40906174,0,947290,-10741609,2020-02-25,2020-02-25,
40906174,437732,0,-11179341,2020-02-25,2020-02-25,Education
40906174,15374,0,-11194715,2020-02-25,2020-02-25,Healthcare
40906174,816058,0,-12074184,2020-02-26,2020-02-26,Education
40906174,0,729980,-11344204,2020-02-26,2020-02-26,
40906174,19191,0,-11363395,2020-02-26,2020-02-26,Groceries
40906174,608003,0,-11971398,2020-02-27,2020-02-27,Healthcare
40906174,0,10846,-11960552,2020-02-27,2020-02-27,
40906174,887820,0,-12848372,2020-02-28,2020-02-28,Entertainment
40906174,0,793521,-12859840,2020-02-28,2020-02-28,
40906174,923915,0,-13483487,2020-02-29,2020-02-29,Education
40906174,0,675564,-12807923,2020-02-29,2020-02-29,
40906174,0,831849,-11976074,2020-02-29,2020-02-29,
40906174,0,17711,-11958363,2020-03-01,2020-03-01,
40906174,0,12709,-11945654,2020-03-01,2020-03-01,
40906174,13222,0,-11958876,2020-03-01,2020-03-01,Bill Sharing
40906174,0,685340,-11273536,2020-03-02,2020-03-02,
40906174,0,15515,-11258021,2020-03-02,2020-03-02,
40906174,769677,0,-12027698,2020-03-03,2020-03-03,Groceries
40906174,888511,0,-12916209,2020-03-04,2020-03-04,Entertainment
40906174,0,880753,-12035456,2020-03-04,2020-03-04,
40906174,814670,0,-12850126,2020-03-05,2020-03-05,Rent
40906174,0,19219,-12830907,2020-03-05,2020-03-05,
40906174,0,12064,-12818843,2020-03-06,2020-03-06,
40906174,17179,0,-12836022,2020-03-06,2020-03-06,Healthcare
40906174,0,615526,-12220496,2020-03-06,2020-03-06,
40906174,0,18425,-12202071,2020-03-07,2020-03-07,
40906174,0,834194,-11367877,2020-03-07,2020-03-07,
40906174,515038,0,-11882915,2020-03-08,2020-03-08,Entertainment
40906174,0,14995,-11867920,2020-03-08,2020-03-08,
40906174,571160,0,-12439080,2020-03-09,2020-03-09,Groceries
40906174,0,556382,-12451162,2020-03-09,2020-03-09,
40906174,673726,0,-12466842,2020-03-10,2020-03-10,Education
40906174,458137,0,-12924979,2020-03-10,2020-03-10,Healthcare
40906174,0,820540,-12104439,2020-03-10,2020-03-10,
40906174,0,966276,-11138163,2020-03-11,2020-03-11,
40906174,0,693210,-10444953,2020-03-12,2020-03-12,
40906174,15173,0,-10460126,2020-03-12,2020-03-12,Healthcare
40906174,0,438401,-10021725,2020-03-12,2020-03-12,
40906174,797892,0,-10819617,2020-03-13,2020-03-13,Education
40906174,0,840274,-9979343,2020-03-13,2020-03-13,
40906174,17225,0,-9996568,2020-03-13,2020-03-13,Rent
40906174,15601,0,-10012169,2020-03-14,2020-03-14,Clothes
40906174,11550,0,-10023719,2020-03-14,2020-03-14,Education
40906174,0,617016,-9406703,2020-03-14,2020-03-14,
40906174,931858,0,-10338561,2020-03-15,2020-03-15,Utilities
40906174,500982,0,-10839543,2020-03-16,2020-03-16,Entertainment
40906174,0,18165,-10821378,2020-03-16,2020-03-16,
40906174,0,997770,-9823608,2020-03-16,2020-03-16,
40906174,16680,0,-9840288,2020-03-17,2020-03-17,Utilities
40906174,619500,0,-10459788,2020-03-17,2020-03-17,Transportation
40906174,722241,0,-11182029,2020-03-17,2020-03-17,Transportation
40906174,955971,0,-12138000,2020-03-18,2020-03-18,Utilities
40906174,0,10757,-12127243,2020-03-19,2020-03-19,
40906174,0,868145,-11259098,2020-03-19,2020-03-19,
40906174,0,11376,-11247722,2020-03-20,2020-03-20,
40906174,627622,0,-11875344,2020-03-21,2020-03-21,Entertainment
40906174,19595,0,-11894939,2020-03-22,2020-03-22,Entertainment
40906174,577996,0,-12472935,2020-03-23,2020-03-23,Transportation
40906174,0,813516,-11659419,2020-03-23,2020-03-23,
40906174,0,626212,-11033207,2020-03-23,2020-03-23,
40906174,0,966773,-10066434,2020-03-24,2020-03-24,
40906174,18507,0,-10084941,2020-03-24,2020-03-24,Rent
40906174,0,793336,-9291605,2020-03-25,2020-03-25,
40906174,18262,0,-9309867,2020-03-25,2020-03-25,Rent
40906174,531813,0,-9841680,2020-03-25,2020-03-25,Healthcare
40906174,439091,0,-10280771,2020-03-26,2020-03-26,Healthcare
40906174,773484,0,-11054255,2020-03-26,2020-03-26,Groceries
40906174,450406,0,-11504661,2020-03-27,2020-03-27,Transportation
40906174,11280,0,-11515941,2020-03-27,2020-03-27,Rent
40906174,765168,0,-12281109,2020-03-28,2020-03-28,Transportation
40906174,0,11748,-12269361,2020-03-28,2020-03-28,
40906174,19628,0,-12288989,2020-03-28,2020-03-28,Transportation
40906174,705056,0,-12994045,2020-03-29,2020-03-29,Rent
40906174,0,725517,-12268528,2020-03-29,2020-03-29,
40906174,0,11812,-12256716,2020-03-30,2020-03-30,
40906174,498980,0,-12755696,2020-03-30,2020-03-30,Clothes
40906174,0,533709,-12221987,2020-03-31,2020-03-31,
40906174,10284,0,-12232271,2020-04-01,2020-04-01,Transportation
40906174,0,418918,-11813353,2020-04-02,2020-04-02,
40906174,0,18854,-11794499,2020-04-03,2020-04-03,
40906174,17388,0,-11811887,2020-04-04,2020-04-04,Education
40906174,474961,0,-12286848,2020-04-04,2020-04-04,Clothes
40906174,817009,0,-13103857,2020-04-05,2020-04-05,Bill Sharing
40906174,17333,0,-13121190,2020-04-05,2020-04-05,Entertainment
40906174,0,10800,-13110390,2020-04-05,2020-04-05,
40906174,0,511666,-12598724,2020-04-06,2020-04-06,
40906174,957663,0,-13556387,2020-04-07,2020-04-07,Entertainment
40906174,0,635877,-12920510,2020-04-07,2020-04-07,
40906174,0,11953,-12908557,2020-04-08,2020-04-08,
40906174,0,522746,-12385811,2020-04-08,2020-04-08,
40906174,835853,0,-13221664,2020-04-08,2020-04-08,Groceries
40906174,0,716468,-12505196,2020-04-09,2020-04-09,
40906174,0,737809,-11767387,2020-04-09,2020-04-09,
40906174,765091,0,-12532478,2020-04-09,2020-04-09,Healthcare
40906174,911104,0,-13443582,2020-04-10,2020-04-10,Entertainment
40906174,0,19145,-13424437,2020-04-10,2020-04-10,
40906174,0,12359,-13412078,2020-04-11,2020-04-11,
40906174,954861,0,-14366939,2020-04-11,2020-04-11,Groceries
40906174,0,11746,-14355193,2020-04-11,2020-04-11,
40906174,0,464507,-13890686,2020-04-12,2020-04-12,
40906174,0,15312,-13875374,2020-04-12,2020-04-12,
40906174,0,957427,-12917947,2020-04-13,2020-04-13,
40906174,988209,0,-13906156,2020-04-13,2020-04-13,Rent
40906174,16095,0,-13922251,2020-04-14,2020-04-14,Utilities
40906174,12245,0,-13934496,2020-04-14,2020-04-14,Utilities
40906174,0,569679,-13364817,2020-04-15,2020-04-15,
40906174,12867,0,-13377684,2020-04-15,2020-04-15,Clothes
40906174,0,19886,-13357798,2020-04-16,2020-04-16,
40906174,0,672379,-12685419,2020-04-17,2020-04-17,
40906174,0,703126,-11982293,2020-04-17,2020-04-17,
40906174,12419,0,-11994712,2020-04-17,2020-04-17,Entertainment
40906174,11159,0,-12005871,2020-04-18,2020-04-18,Transportation
40906174,640276,0,-12646147,2020-04-18,2020-04-18,Transportation
40906174,0,593218,-12052929,2020-04-19,2020-04-19,
40906174,947245,0,-13000174,2020-04-19,2020-04-19,Education
40906174,0,594181,-12405993,2020-04-20,2020-04-20,
40906174,17109,0,-12423102,2020-04-21,2020-04-21,Groceries
40906174,0,647055,-11776047,2020-04-21,2020-04-21,
40906174,0,701415,-11074632,2020-04-22,2020-04-22,
40906174,18229,0,-11092861,2020-04-22,2020-04-22,Entertainment
40906174,18540,0,-11111401,2020-04-22,2020-04-22,Rent
40906174,414494,0,-11525895,2020-04-23,2020-04-23,Bill Sharing
40906174,697534,0,-12223429,2020-04-23,2020-04-23,Entertainment
40906174,0,823030,-11400399,2020-04-23,2020-04-23,
40906174,530193,0,-11930592,2020-04-24,2020-04-24,Entertainment
40906174,929233,0,-12859825,2020-04-24,2020-04-24,Healthcare
40906174,0,16848,-12842977,2020-04-24,2020-04-24,
40906174,12268,0,-12855245,2020-04-25,2020-04-25,Rent
40906174,14572,0,-12869817,2020-04-26,2020-04-26,Rent
40906174,0,655981,-12213836,2020-04-27,2020-04-27,
40906174,0,591073,-12196184,2020-04-27,2020-04-27,
40906174,0,14754,-12181430,2020-04-27,2020-04-27,
40906174,17640,0,-12199070,2020-04-28,2020-04-28,Groceries
40906174,0,894187,-11363738,2020-04-28,2020-04-28,
40906174,487632,0,-11851370,2020-04-28,2020-04-28,Rent
40906174,0,767004,-11084366,2020-04-29,2020-04-29,
40906174,905281,0,-11989647,2020-04-29,2020-04-29,Entertainment
40906174,0,613450,-11376197,2020-04-29,2020-04-29,
40906174,0,692599,-10683598,2020-04-30,2020-04-30,
40906174,12823,0,-10696421,2020-04-30,2020-04-30,Rent
40906174,838498,0,-11534919,2020-04-30,2020-04-30,Clothes
40906174,958892,0,-12493811,2020-05-01,2020-05-01,Groceries
40906174,0,637754,-11856057,2020-05-02,2020-05-02,
40906174,878781,0,-12734838,2020-05-03,2020-05-03,Groceries
40906174,0,15955,-12718883,2020-05-04,2020-05-04,
40906174,0,447786,-12271097,2020-05-04,2020-05-04,
40906174,12728,0,-12283825,2020-05-04,2020-05-04,Utilities
40906174,0,18694,-12265131,2020-05-05,2020-05-05,
40906174,0,730623,-11534508,2020-05-05,2020-05-05,
40906174,0,18186,-11516322,2020-05-06,2020-05-06,
40906174,0,605809,-10910513,2020-05-06,2020-05-06,
40906174,17259,0,-10927772,2020-05-06,2020-05-06,Education
40906174,18176,0,-10945948,2020-05-07,2020-05-07,Healthcare
40906174,0,611624,-10334324,2020-05-07,2020-05-07,
40906174,17581,0,-10351905,2020-05-07,2020-05-07,Groceries
40906174,656078,0,-11007983,2020-05-08,2020-05-08,Transportation
40906174,0,495094,-10512889,2020-05-08,2020-05-08,
40906174,459185,0,-10497279,2020-05-08,2020-05-08,Healthcare
40906174,976501,0,-11473780,2020-05-09,2020-05-09,Healthcare
40906174,0,490781,-10982999,2020-05-09,2020-05-09,
40906174,16339,0,-10999338,2020-05-09,2020-05-09,Entertainment
40906174,0,958803,-10211531,2020-05-10,2020-05-10,
40906174,10228,0,-10221759,2020-05-10,2020-05-10,Transportation
40906174,0,15995,-10205764,2020-05-11,2020-05-11,
40906174,855077,0,-11060841,2020-05-11,2020-05-11,Utilities
40906174,0,10106,-11050735,2020-05-12,2020-05-12,
40906174,0,15116,-11035619,2020-05-12,2020-05-12,
40906174,911123,0,-11946742,2020-05-13,2020-05-13,Healthcare
40906174,0,456832,-11489910,2020-05-13,2020-05-13,
40906174,0,424644,-11065266,2020-05-14,2020-05-14,
40906174,716952,0,-11782218,2020-05-14,2020-05-14,Entertainment
40906174,0,15509,-11766709,2020-05-14,2020-05-14,
40906174,0,479609,-11287100,2020-05-15,2020-05-15,
40906174,0,15917,-11271183,2020-05-16,2020-05-16,
40906174,758056,0,-12029239,2020-05-16,2020-05-16,Groceries
40906174,825705,0,-12854944,2020-05-16,2020-05-16,Rent
40906174,0,19512,-12835432,2020-05-17,2020-05-17,
40906174,749657,0,-13585089,2020-05-18,2020-05-18,Entertainment
40906174,0,793392,-12791697,2020-05-18,2020-05-18,
40906174,732121,0,-13523818,2020-05-18,2020-05-18,Healthcare
40906174,11524,0,-13535342,2020-05-19,2020-05-19,Clothes
40906174,0,16220,-13519122,2020-05-19,2020-05-19,
40906174,0,870229,-12648893,2020-05-20,2020-05-20,
40906174,0,16207,-12632686,2020-05-20,2020-05-20,
40906174,676717,0,-13309403,2020-05-21,2020-05-21,Education
40906174,404598,0,-13714001,2020-05-21,2020-05-21,Groceries
40906174,649509,0,-14363510,2020-05-21,2020-05-21,Entertainment
40906174,0,14473,-14349037,2020-05-22,2020-05-22,
40906174,0,15097,-14333940,2020-05-23,2020-05-23,
40906174,11968,0,-14345908,2020-05-24,2020-05-24,Transportation
40906174,0,833740,-13512168,2020-05-24,2020-05-24,
40906174,16486,0,-13528654,2020-05-25,2020-05-25,Healthcare
40906174,0,19867,-13508787,2020-05-25,2020-05-25,
40906174,0,11899,-13496888,2020-05-25,2020-05-25,
40906174,736891,0,-14233779,2020-05-26,2020-05-26,Education
40906174,0,19767,-14214012,2020-05-26,2020-05-26,
40906174,0,19332,-14194680,2020-05-26,2020-05-26,
40906174,0,11806,-14182874,2020-05-27,2020-05-27,
40906174,10257,0,-14193131,2020-05-27,2020-05-27,Transportation
40906174,11162,0,-14204293,2020-05-27,2020-05-27,Education
40906174,17206,0,-14221499,2020-05-28,2020-05-28,Utilities
40906174,14186,0,-14235685,2020-05-28,2020-05-28,Bill Sharing
40906174,400551,0,-14636236,2020-05-29,2020-05-29,Transportation
40906174,754299,0,-15390535,2020-05-29,2020-05-29,Transportation
40906174,0,10816,-15379719,2020-05-30,2020-05-30,
40906174,11706,0,-15391425,2020-05-30,2020-05-30,Education
40906174,629653,0,-16021078,2020-05-30,2020-05-30,Education
40906174,614833,0,-16635911,2020-05-31,2020-05-31,Transportation
40906174,15680,0,-16651591,2020-05-31,2020-05-31,Transportation
40906174,0,15780,-16635811,2020-06-01,2020-06-01,
40906174,15802,0,-16651613,2020-06-02,2020-06-02,Transportation
40906174,16076,0,-16667689,2020-06-02,2020-06-02,Utilities
40906174,683619,0,-17351308,2020-06-02,2020-06-02,Education
40906174,0,12052,-17339256,2020-06-03,2020-06-03,
40906174,0,987144,-17325386,2020-06-03,2020-06-03,
40906174,602006,0,-17927392,2020-06-04,2020-06-04,Groceries
40906174,13079,0,-17940471,2020-06-04,2020-06-04,Education
40906174,13425,0,-17953896,2020-06-05,2020-06-05,Education
40906174,0,719065,-17234831,2020-06-05,2020-06-05,
40906174,543184,0,-17778015,2020-06-05,2020-06-05,Groceries
40906174,0,19031,-17758984,2020-06-06,2020-06-06,
40906174,13814,0,-17772798,2020-06-07,2020-06-07,Bill Sharing
40906174,978273,0,-18751071,2020-06-07,2020-06-07,Utilities
40906174,0,19740,-18731331,2020-06-08,2020-06-08,
40906174,16911,0,-18748242,2020-06-08,2020-06-08,Healthcare
40906174,624751,0,-19372993,2020-06-09,2020-06-09,Rent
40906174,553630,0,-19926623,2020-06-10,2020-06-10,Groceries
40906174,911979,0,-20838602,2020-06-10,2020-06-10,Healthcare
40906174,0,16198,-20822404,2020-06-10,2020-06-10,
40906174,18112,0,-20840516,2020-06-11,2020-06-11,Groceries
40906174,0,970054,-19870462,2020-06-11,2020-06-11,
40906174,0,19874,-19850588,2020-06-11,2020-06-11,
40906174,12552,0,-19863140,2020-06-12,2020-06-12,Utilities
40906174,11912,0,-19875052,2020-06-12,2020-06-12,Utilities
40906174,15693,0,-19890745,2020-06-13,2020-06-13,Groceries
40906174,0,473469,-19417276,2020-06-13,2020-06-13,
40906174,19074,0,-19436350,2020-06-13,2020-06-13,Entertainment
40906174,0,11735,-19424615,2020-06-14,2020-06-14,
40906174,912636,0,-20337251,2020-06-15,2020-06-15,Groceries
40906174,14948,0,-20352199,2020-06-15,2020-06-15,Entertainment
40906174,701011,0,-21053210,2020-06-16,2020-06-16,Groceries
40906174,650387,0,-21703597,2020-06-16,2020-06-16,Utilities
40906174,0,916333,-20787264,2020-06-17,2020-06-17,
40906174,722705,0,-21509969,2020-06-17,2020-06-17,Rent
40906174,0,17512,-21492457,2020-06-18,2020-06-18,
40906174,0,15986,-21476471,2020-06-18,2020-06-18,
40906174,0,550766,-20925705,2020-06-19,2020-06-19,
40906174,13810,0,-20939515,2020-06-20,2020-06-20,Bill Sharing
40906174,0,782344,-20157171,2020-06-21,2020-06-21,
40906174,0,10584,-20146587,2020-06-21,2020-06-21,
40906174,0,841336,-19305251,2020-06-21,2020-06-21,
40906174,0,577466,-18727785,2020-06-22,2020-06-22,
40906174,0,768094,-17959691,2020-06-22,2020-06-22,
40906174,755192,0,-18714883,2020-06-22,2020-06-22,Groceries
40906174,420779,0,-19135662,2020-06-23,2020-06-23,Utilities
40906174,505184,0,-19145796,2020-06-24,2020-06-24,Education
40906174,0,758026,-18387770,2020-06-24,2020-06-24,
40906174,18676,0,-18406446,2020-06-25,2020-06-25,Education
40906174,0,713908,-17692538,2020-06-25,2020-06-25,
40906174,0,881749,-16810789,2020-06-26,2020-06-26,
40906174,0,964865,-15845924,2020-06-26,2020-06-26,
40906174,678575,0,-16524499,2020-06-26,2020-06-26,Clothes
40906174,0,14965,-16509534,2020-06-27,2020-06-27,
40906174,469381,0,-16978915,2020-06-28,2020-06-28,Healthcare
40906174,0,800719,-16178196,2020-06-28,2020-06-28,
40906174,762488,0,-16940684,2020-06-28,2020-06-28,Education
40906174,711755,0,-17652439,2020-06-29,2020-06-29,Entertainment
40906174,670638,0,-18323077,2020-06-29,2020-06-29,Bill Sharing
40906174,0,13817,-18309260,2020-06-30,2020-06-30,
40906174,18291,0,-18327551,2020-06-30,2020-06-30,Entertainment
40906174,461413,0,-18788964,2020-06-30,2020-06-30,Clothes
40906174,0,11136,-18777828,2020-07-01,2020-07-01,
40906174,0,12431,-18765397,2020-07-01,2020-07-01,
40906174,0,15631,-18749766,2020-07-01,2020-07-01,
40906174,0,703448,-18046318,2020-07-02,2020-07-02,
40906174,0,838308,-17208010,2020-07-02,2020-07-02,
40906174,0,931845,-16276165,2020-07-03,2020-07-03,
40906174,11033,0,-16287198,2020-07-03,2020-07-03,Clothes
40906174,450263,0,-16737461,2020-07-04,2020-07-04,Transportation
40906174,0,586360,-16151101,2020-07-05,2020-07-05,
40906174,712867,0,-16863968,2020-07-06,2020-07-06,Utilities
40906174,19508,0,-16883476,2020-07-06,2020-07-06,Healthcare
40906174,625265,0,-17508741,2020-07-06,2020-07-06,Bill Sharing
40906174,0,402903,-17105838,2020-07-07,2020-07-07,
40906174,0,19785,-17086053,2020-07-08,2020-07-08,
40906174,0,834337,-16251716,2020-07-08,2020-07-08,
40906174,13009,0,-16264725,2020-07-08,2020-07-08,Education
40906174,0,926696,-15481375,2020-07-09,2020-07-09,
40906174,0,459649,-15021726,2020-07-09,2020-07-09,
40906174,0,14458,-15007268,2020-07-09,2020-07-09,
40906174,0,13580,-14993688,2020-07-10,2020-07-10,
40906174,17154,0,-15010842,2020-07-10,2020-07-10,Bill Sharing
40906174,0,19662,-14991180,2020-07-10,2020-07-10,
40906174,0,896670,-14094510,2020-07-11,2020-07-11,
40906174,0,19688,-14074822,2020-07-11,2020-07-11,
40906174,0,19416,-14055406,2020-07-11,2020-07-11,
40906174,17548,0,-14072954,2020-07-12,2020-07-12,Transportation
40906174,662698,0,-14054637,2020-07-12,2020-07-12,Education
40906174,465165,0,-14519802,2020-07-13,2020-07-13,Bill Sharing
40906174,735682,0,-15255484,2020-07-13,2020-07-13,Healthcare
40906174,13010,0,-15268494,2020-07-14,2020-07-14,Entertainment
40906174,16835,0,-15285329,2020-07-14,2020-07-14,Utilities
40906174,0,980943,-14304386,2020-07-15,2020-07-15,
40906174,0,911952,-13392434,2020-07-15,2020-07-15,
40906174,637604,0,-14030038,2020-07-16,2020-07-16,Education
40906174,17569,0,-14047607,2020-07-17,2020-07-17,Clothes
40906174,0,957763,-13089844,2020-07-17,2020-07-17,
40906174,0,15706,-13074138,2020-07-17,2020-07-17,
40906174,932540,0,-14006678,2020-07-18,2020-07-18,Utilities
40906174,582005,0,-14588683,2020-07-19,2020-07-19,Utilities
40906174,0,10071,-14578612,2020-07-19,2020-07-19,
40906174,0,554481,-14024131,2020-07-19,2020-07-19,
40906174,0,18984,-14005147,2020-07-20,2020-07-20,
40906174,19136,0,-14024283,2020-07-21,2020-07-21,Utilities
40906174,0,13898,-14010385,2020-07-22,2020-07-22,
40906174,0,663008,-13347377,2020-07-23,2020-07-23,
40906174,0,971477,-12375900,2020-07-24,2020-07-24,
40906174,14145,0,-12390045,2020-07-25,2020-07-25,Education
40906174,15404,0,-12405449,2020-07-26,2020-07-26,Transportation
40906174,10577,0,-12416026,2020-07-26,2020-07-26,Healthcare
40906174,419635,0,-12835661,2020-07-27,2020-07-27,Entertainment
40906174,836759,0,-12824864,2020-07-28,2020-07-28,Healthcare
40906174,860829,0,-13685693,2020-07-28,2020-07-28,Education
40906174,13625,0,-13699318,2020-07-29,2020-07-29,Clothes
40906174,887122,0,-13688341,2020-07-29,2020-07-29,Education
40906174,984899,0,-14673240,2020-07-29,2020-07-29,Groceries
40906174,0,905377,-13767863,2020-07-30,2020-07-30,
40906174,0,15880,-13751983,2020-07-30,2020-07-30,
40906174,0,741360,-13010623,2020-07-31,2020-07-31,
40906174,0,18702,-12991921,2020-07-31,2020-07-31,
40906174,0,19740,-12972181,2020-08-01,2020-08-01,
40906174,658251,0,-13630432,2020-08-01,2020-08-01,Clothes
40906174,18156,0,-13648588,2020-08-02,2020-08-02,Bill Sharing
40906174,0,965327,-12683261,2020-08-03,2020-08-03,
40906174,16425,0,-12699686,2020-08-03,2020-08-03,Groceries
40906174,0,784206,-12712270,2020-08-03,2020-08-03,
40906174,10731,0,-12723001,2020-08-04,2020-08-04,Rent
40906174,13387,0,-12736388,2020-08-04,2020-08-04,Education
40906174,19904,0,-12756292,2020-08-05,2020-08-05,Groceries
40906174,641811,0,-13398103,2020-08-05,2020-08-05,Entertainment
40906174,0,16863,-13381240,2020-08-05,2020-08-05,
40906174,0,912201,-12469039,2020-08-06,2020-08-06,
40906174,16638,0,-12485677,2020-08-06,2020-08-06,Bill Sharing
40906174,0,947662,-11538015,2020-08-07,2020-08-07,
40906174,660996,0,-12199011,2020-08-07,2020-08-07,Healthcare
40906174,0,13458,-12185553,2020-08-07,2020-08-07,
40906174,803476,0,-12989029,2020-08-08,2020-08-08,Healthcare
40906174,408932,0,-13397961,2020-08-08,2020-08-08,Entertainment
40906174,0,15477,-13382484,2020-08-08,2020-08-08,
40906174,0,417268,-12965216,2020-08-09,2020-08-09,
40906174,14215,0,-12979431,2020-08-09,2020-08-09,Clothes
40906174,0,10454,-12968977,2020-08-09,2020-08-09,
40906174,0,12268,-12956709,2020-08-10,2020-08-10,
40906174,633802,0,-13590511,2020-08-10,2020-08-10,Rent
40906174,17555,0,-13608066,2020-08-11,2020-08-11,Groceries
40906174,0,10792,-13597274,2020-08-11,2020-08-11,
40906174,17392,0,-13614666,2020-08-12,2020-08-12,Groceries
40906174,0,735342,-12879324,2020-08-13,2020-08-13,
40906174,427003,0,-13306327,2020-08-13,2020-08-13,Entertainment
40906174,885118,0,-14191445,2020-08-14,2020-08-14,Clothes
40906174,831176,0,-15022621,2020-08-14,2020-08-14,Clothes
40906174,867249,0,-15889870,2020-08-15,2020-08-15,Transportation
40906174,16723,0,-15906593,2020-08-15,2020-08-15,Rent
40906174,782292,0,-16688885,2020-08-15,2020-08-15,Utilities
40906174,783383,0,-17472268,2020-08-16,2020-08-16,Entertainment
40906174,0,15184,-17457084,2020-08-16,2020-08-16,
40906174,436713,0,-17893797,2020-08-16,2020-08-16,Entertainment
40906174,16224,0,-17910021,2020-08-17,2020-08-17,Transportation
40906174,19938,0,-17929959,2020-08-18,2020-08-18,Education
40906174,602845,0,-18532804,2020-08-18,2020-08-18,Entertainment
40906174,0,980917,-17551887,2020-08-19,2020-08-19,
40906174,10774,0,-17562661,2020-08-19,2020-08-19,Transportation
40906174,0,19820,-17542841,2020-08-19,2020-08-19,
40906174,0,16252,-17526589,2020-08-20,2020-08-20,
40906174,0,14231,-17512358,2020-08-21,2020-08-21,
40906174,0,13359,-17498999,2020-08-22,2020-08-22,
40906174,982162,0,-18481161,2020-08-22,2020-08-22,Healthcare
40906174,0,495272,-17985889,2020-08-23,2020-08-23,
40906174,420466,0,-18406355,2020-08-24,2020-08-24,Healthcare
40906174,0,409738,-17996617,2020-08-24,2020-08-24,
40906174,602106,0,-18598723,2020-08-24,2020-08-24,Education
40906174,0,974829,-17623894,2020-08-25,2020-08-25,
40906174,417369,0,-18041263,2020-08-26,2020-08-26,Entertainment
40906174,0,19003,-18022260,2020-08-27,2020-08-27,
40906174,0,10067,-18012193,2020-08-27,2020-08-27,
40906174,643599,0,-18655792,2020-08-27,2020-08-27,Entertainment
40906174,714511,0,-19370303,2020-08-28,2020-08-28,Transportation
40906174,771119,0,-20141422,2020-08-28,2020-08-28,Healthcare
40906174,0,18397,-20123025,2020-08-29,2020-08-29,
40906174,0,648329,-19474696,2020-08-30,2020-08-30,
40906174,0,982594,-18492102,2020-08-30,2020-08-30,
40906174,0,711366,-17780736,2020-08-31,2020-08-31,
40906174,957041,0,-18737777,2020-08-31,2020-08-31,Healthcare
40906174,0,15052,-18722725,2020-09-01,2020-09-01,
40906174,17198,0,-18739923,2020-09-01,2020-09-01,Rent
40906174,499295,0,-19239218,2020-09-01,2020-09-01,Bill Sharing
40906174,592101,0,-19831319,2020-09-02,2020-09-02,Healthcare
40906174,0,650069,-19181250,2020-09-02,2020-09-02,
40906174,0,757464,-18423786,2020-09-03,2020-09-03,
40906174,0,19823,-18403963,2020-09-03,2020-09-03,
40906174,0,537904,-17866059,2020-09-04,2020-09-04,
40906174,10678,0,-17876737,2020-09-04,2020-09-04,Rent
40906174,945491,0,-18822228,2020-09-04,2020-09-04,Education
40906174,0,14307,-18807921,2020-09-05,2020-09-05,
40906174,500801,0,-19308722,2020-09-05,2020-09-05,Healthcare
40906174,14948,0,-19323670,2020-09-05,2020-09-05,Education
40906174,778387,0,-20102057,2020-09-06,2020-09-06,Healthcare
40906174,526330,0,-20628387,2020-09-06,2020-09-06,Groceries
40906174,0,547987,-20080400,2020-09-06,2020-09-06,
40906174,913968,0,-20994368,2020-09-07,2020-09-07,Rent
40906174,876542,0,-21870910,2020-09-07,2020-09-07,Healthcare
40906174,504100,0,-22375010,2020-09-07,2020-09-07,Clothes
40906174,436299,0,-22811309,2020-09-08,2020-09-08,Entertainment
40906174,468841,0,-23280150,2020-09-09,2020-09-09,Transportation
40906174,11701,0,-23291851,2020-09-09,2020-09-09,Utilities
40906174,500408,0,-23792259,2020-09-09,2020-09-09,Bill Sharing
40906174,757168,0,-24549427,2020-09-10,2020-09-10,Healthcare
40906174,0,656452,-23892975,2020-09-10,2020-09-10,
40906174,0,12127,-23880848,2020-09-11,2020-09-11,
40906174,0,825636,-23055212,2020-09-11,2020-09-11,
40906174,576160,0,-23631372,2020-09-12,2020-09-12,Education
40906174,12245,0,-23643617,2020-09-12,2020-09-12,Entertainment
40906174,650708,0,-24294325,2020-09-12,2020-09-12,Rent
40906174,10703,0,-24305028,2020-09-13,2020-09-13,Rent
40906174,620542,0,-24925570,2020-09-14,2020-09-14,Bill Sharing
40906174,441185,0,-25366755,2020-09-14,2020-09-14,Utilities
40906174,503934,0,-25870689,2020-09-14,2020-09-14,Entertainment
40906174,0,868882,-25001807,2020-09-15,2020-09-15,
40906174,0,969602,-24032205,2020-09-16,2020-09-16,
40906174,618525,0,-24650730,2020-09-16,2020-09-16,Healthcare
40906174,0,16352,-24634378,2020-09-16,2020-09-16,
40906174,0,552695,-24081683,2020-09-17,2020-09-17,
40906174,0,890714,-23190969,2020-09-18,2020-09-18,
40906174,0,10226,-23180743,2020-09-19,2020-09-19,
40906174,840333,0,-24021076,2020-09-19,2020-09-19,Bill Sharing
40906174,963480,0,-24984556,2020-09-19,2020-09-19,Utilities
40906174,694515,0,-25679071,2020-09-20,2020-09-20,Bill Sharing
40906174,0,626386,-25052685,2020-09-21,2020-09-21,
40906174,0,944000,-24108685,2020-09-21,2020-09-21,
40906174,0,12750,-24095935,2020-09-22,2020-09-22,
40906174,0,19391,-24076544,2020-09-22,2020-09-22,
40906174,626547,0,-24703091,2020-09-22,2020-09-22,Entertainment
40906174,500779,0,-25203870,2020-09-23,2020-09-23,Clothes
40906174,693634,0,-25897504,2020-09-23,2020-09-23,Clothes
40906174,13063,0,-25910567,2020-09-23,2020-09-23,Education
40906174,0,12059,-25898508,2020-09-24,2020-09-24,
40906174,0,852361,-25046147,2020-09-25,2020-09-25,
40906174,17762,0,-25063909,2020-09-25,2020-09-25,Entertainment
40906174,0,472440,-24591469,2020-09-25,2020-09-25,
40906174,650846,0,-25242315,2020-09-26,2020-09-26,Clothes
40906174,11778,0,-25254093,2020-09-26,2020-09-26,Entertainment
40906174,0,958340,-24295753,2020-09-27,2020-09-27,
40906174,619637,0,-25012021,2020-09-28,2020-09-28,Education
40906174,893193,0,-25905214,2020-09-28,2020-09-28,Groceries
40906174,679341,0,-26584555,2020-09-29,2020-09-29,Groceries
40906174,0,12447,-26572108,2020-09-29,2020-09-29,
40906174,0,12878,-26559230,2020-09-29,2020-09-29,
40906174,0,419776,-26139454,2020-09-30,2020-09-30,
40906174,0,10786,-26128668,2020-10-01,2020-10-01,
40906174,0,477494,-25651174,2020-10-01,2020-10-01,
40906174,0,18794,-25632380,2020-10-01,2020-10-01,
40906174,0,988153,-24644227,2020-10-02,2020-10-02,
40906174,0,13337,-24630890,2020-10-03,2020-10-03,
40906174,17643,0,-24648533,2020-10-03,2020-10-03,Transportation
40906174,647307,0,-25295840,2020-10-04,2020-10-04,Rent
40906174,0,513137,-24782703,2020-10-04,2020-10-04,
40906174,831427,0,-25614130,2020-10-04,2020-10-04,Groceries
40906174,16080,0,-25630210,2020-10-05,2020-10-05,Groceries
40906174,951524,0,-26581734,2020-10-06,2020-10-06,Rent
40906174,898355,0,-27480089,2020-10-06,2020-10-06,Utilities
40906174,0,11846,-27468243,2020-10-06,2020-10-06,
40906174,0,11301,-27456942,2020-10-07,2020-10-07,
40906174,811751,0,-28268693,2020-10-07,2020-10-07,Clothes
40906174,13838,0,-28282531,2020-10-08,2020-10-08,Clothes
40906174,19660,0,-28302191,2020-10-09,2020-10-09,Transportation
40906174,858564,0,-29160755,2020-10-10,2020-10-10,Transportation
40906174,0,622923,-28537832,2020-10-10,2020-10-10,
40906174,0,12498,-28525334,2020-10-10,2020-10-10,
40906174,695389,0,-29220723,2020-10-11,2020-10-11,Education
40906174,0,809822,-28410901,2020-10-11,2020-10-11,
40906174,11551,0,-28422452,2020-10-11,2020-10-11,Utilities
40906174,0,933293,-29017754,2020-10-12,2020-10-12,
40906174,0,659224,-28358530,2020-10-12,2020-10-12,
40906174,726660,0,-28375321,2020-10-13,2020-10-13,Education
40906174,0,10089,-28365232,2020-10-14,2020-10-14,
40906174,860562,0,-29225794,2020-10-14,2020-10-14,Clothes
40906174,0,10330,-29215464,2020-10-14,2020-10-14,
40906174,0,14627,-29200837,2020-10-15,2020-10-15,
40906174,764594,0,-29965431,2020-10-16,2020-10-16,Clothes
40906174,0,15200,-29950231,2020-10-16,2020-10-16,
40906174,856209,0,-30806440,2020-10-16,2020-10-16,Groceries
40906174,10888,0,-30817328,2020-10-17,2020-10-17,Transportation
40906174,0,18157,-30799171,2020-10-18,2020-10-18,
40906174,14146,0,-30813317,2020-10-19,2020-10-19,Clothes
40906174,0,11880,-30801437,2020-10-19,2020-10-19,
40906174,10165,0,-30811602,2020-10-20,2020-10-20,Entertainment
40906174,828338,0,-31639940,2020-10-20,2020-10-20,Clothes
40906174,0,16907,-31623033,2020-10-20,2020-10-20,
40906174,637396,0,-32260429,2020-10-21,2020-10-21,Transportation
40906174,989850,0,-33250279,2020-10-21,2020-10-21,Entertainment
40906174,795011,0,-34045290,2020-10-22,2020-10-22,Education
40906174,0,638928,-33406362,2020-10-22,2020-10-22,
40906174,676322,0,-34082684,2020-10-22,2020-10-22,Bill Sharing
40906174,0,715807,-33366877,2020-10-23,2020-10-23,
40906174,0,923475,-32443402,2020-10-23,2020-10-23,
40906174,757451,0,-33200853,2020-10-23,2020-10-23,Education
40906174,17194,0,-33218047,2020-10-24,2020-10-24,Bill Sharing
40906174,0,402474,-32815573,2020-10-25,2020-10-25,
40906174,0,966980,-31848593,2020-10-26,2020-10-26,
40906174,0,872353,-30976240,2020-10-26,2020-10-26,
40906174,0,768683,-30207557,2020-10-27,2020-10-27,
40906174,544011,0,-30751568,2020-10-28,2020-10-28,Entertainment
40906174,924727,0,-31676295,2020-10-29,2020-10-29,Utilities
40906174,429475,0,-32105770,2020-10-29,2020-10-29,Entertainment
40906174,10280,0,-32116050,2020-10-30,2020-10-30,Entertainment
40906174,633088,0,-32749138,2020-10-30,2020-10-30,Transportation
40906174,613233,0,-33362371,2020-10-30,2020-10-30,Clothes
40906174,521866,0,-33884237,2020-10-31,2020-10-31,Utilities
40906174,561852,0,-34446089,2020-10-31,2020-10-31,Groceries
40906174,936422,0,-35382511,2020-11-01,2020-11-01,Transportation
40906174,10264,0,-35392775,2020-11-01,2020-11-01,Healthcare
40906174,806464,0,-36199239,2020-11-01,2020-11-01,Rent
40906174,11254,0,-36210493,2020-11-02,2020-11-02,Entertainment
40906174,505512,0,-36716005,2020-11-02,2020-11-02,Bill Sharing
40906174,0,837875,-35878130,2020-11-03,2020-11-03,
40906174,0,654300,-35223830,2020-11-03,2020-11-03,
40906174,0,418041,-34805789,2020-11-04,2020-11-04,
40906174,552040,0,-35357829,2020-11-04,2020-11-04,Entertainment
40906174,746677,0,-36104506,2020-11-04,2020-11-04,Clothes
40906174,0,628521,-35475985,2020-11-05,2020-11-05,
40906174,0,17456,-35458529,2020-11-06,2020-11-06,
40906174,0,427882,-35030647,2020-11-07,2020-11-07,
40906174,591081,0,-34224511,2020-11-07,2020-11-07,Education
40906174,926942,0,-34729362,2020-11-08,2020-11-08,Healthcare
40906174,19658,0,-34749020,2020-11-08,2020-11-08,Healthcare
40906174,0,886722,-33862298,2020-11-09,2020-11-09,
40906174,614416,0,-34476714,2020-11-09,2020-11-09,Healthcare
40906174,16801,0,-34493515,2020-11-09,2020-11-09,Groceries
40906174,609736,0,-35103251,2020-11-10,2020-11-10,Healthcare
40906174,13858,0,-35117109,2020-11-11,2020-11-11,Transportation
40906174,846517,0,-35679965,2020-11-12,2020-11-12,Education
40906174,820981,0,-36500946,2020-11-12,2020-11-12,Entertainment
40906174,0,833943,-35667003,2020-11-12,2020-11-12,
40906174,946109,0,-36613112,2020-11-13,2020-11-13,Healthcare
40906174,10038,0,-36623150,2020-11-13,2020-11-13,Rent
40906174,0,19195,-36603955,2020-11-14,2020-11-14,
40906174,630912,0,-37234867,2020-11-15,2020-11-15,Rent
40906174,0,18588,-37216279,2020-11-15,2020-11-15,
40906174,0,13241,-37203038,2020-11-16,2020-11-16,
40906174,931740,0,-38134778,2020-11-16,2020-11-16,Education
40906174,19176,0,-38153954,2020-11-16,2020-11-16,Groceries
40906174,11170,0,-38165124,2020-11-17,2020-11-17,Entertainment
40906174,0,644817,-37520307,2020-11-18,2020-11-18,
40906174,0,862034,-36658273,2020-11-18,2020-11-18,
40906174,478096,0,-37136369,2020-11-19,2020-11-19,Rent
40906174,0,945482,-36190887,2020-11-19,2020-11-19,
40906174,10236,0,-36201123,2020-11-20,2020-11-20,Transportation
40906174,11595,0,-36212718,2020-11-21,2020-11-21,Entertainment
40906174,0,665537,-35547181,2020-11-22,2020-11-22,
40906174,11399,0,-35558580,2020-11-22,2020-11-22,Utilities
40906174,0,686707,-34871873,2020-11-22,2020-11-22,
40906174,0,15131,-34856742,2020-11-23,2020-11-23,
40906174,787896,0,-35644638,2020-11-24,2020-11-24,Entertainment
40906174,0,874681,-34769957,2020-11-24,2020-11-24,
40906174,0,19946,-34750011,2020-11-25,2020-11-25,
40906174,721631,0,-35471642,2020-11-26,2020-11-26,Education
40906174,0,17755,-35453887,2020-11-26,2020-11-26,
40906174,819876,0,-36273763,2020-11-26,2020-11-26,Rent
40906174,0,512009,-35761754,2020-11-27,2020-11-27,
40906174,0,13995,-35747759,2020-11-27,2020-11-27,
40906174,739474,0,-36487233,2020-11-27,2020-11-27,Transportation
40906174,0,17566,-36469667,2020-11-28,2020-11-28,
40906174,0,11723,-36457944,2020-11-28,2020-11-28,
40906174,0,12515,-36445429,2020-11-28,2020-11-28,
40906174,412605,0,-36858034,2020-11-29,2020-11-29,Clothes
40906174,0,926037,-36877125,2020-11-30,2020-11-30,
40906174,0,10156,-36866969,2020-11-30,2020-11-30,
40906174,0,10541,-36856428,2020-12-01,2020-12-01,
40906174,14698,0,-36871126,2020-12-02,2020-12-02,Healthcare
40906174,0,17891,-36853235,2020-12-02,2020-12-02,
40906174,891527,0,-37744762,2020-12-03,2020-12-03,Healthcare
40906174,18711,0,-37763473,2020-12-04,2020-12-04,Entertainment
40906174,0,570037,-37193436,2020-12-04,2020-12-04,
40906174,0,531785,-36661651,2020-12-04,2020-12-04,
40906174,0,602349,-36059302,2020-12-05,2020-12-05,
40906174,973379,0,-37032681,2020-12-06,2020-12-06,Groceries
40906174,623426,0,-37656107,2020-12-07,2020-12-07,Utilities
40906174,0,822578,-36833529,2020-12-08,2020-12-08,
40906174,644198,0,-36257281,2020-12-08,2020-12-08,Healthcare
40906174,721272,0,-36978553,2020-12-08,2020-12-08,Entertainment
40906174,0,535945,-36442608,2020-12-09,2020-12-09,
40906174,19373,0,-36461981,2020-12-10,2020-12-10,Utilities
40906174,0,520837,-35941144,2020-12-10,2020-12-10,
40906174,10965,0,-35952109,2020-12-11,2020-12-11,Clothes
40906174,17031,0,-35969140,2020-12-11,2020-12-11,Rent
40906174,0,16967,-35952173,2020-12-11,2020-12-11,
40906174,0,447979,-35504194,2020-12-12,2020-12-12,
40906174,0,805949,-34698245,2020-12-12,2020-12-12,
40906174,13507,0,-34711752,2020-12-12,2020-12-12,Bill Sharing
40906174,0,18371,-34693381,2020-12-13,2020-12-13,
40906174,16794,0,-34710175,2020-12-14,2020-12-14,Utilities
40906174,938117,0,-35648292,2020-12-14,2020-12-14,Groceries
40906174,970203,0,-36618495,2020-12-15,2020-12-15,Healthcare
40906174,508611,0,-37127106,2020-12-16,2020-12-16,Education
40906174,681800,0,-37808906,2020-12-17,2020-12-17,Bill Sharing
40906174,435783,0,-38244689,2020-12-17,2020-12-17,Clothes
40906174,18490,0,-38263179,2020-12-18,2020-12-18,Utilities
40906174,0,10109,-38253070,2020-12-19,2020-12-19,
40906174,0,10244,-38242826,2020-12-20,2020-12-20,
40906174,852299,0,-39095125,2020-12-21,2020-12-21,Education
40906174,0,419232,-38675893,2020-12-21,2020-12-21,
40906174,532299,0,-39208192,2020-12-22,2020-12-22,Groceries
40906174,14345,0,-39222537,2020-12-22,2020-12-22,Groceries
40906174,0,625088,-38597449,2020-12-23,2020-12-23,
40906174,943245,0,-39540694,2020-12-23,2020-12-23,Education
40906174,0,965976,-38819783,2020-12-24,2020-12-24,
40906174,11975,0,-38831758,2020-12-24,2020-12-24,Bill Sharing
40906174,11670,0,-38843428,2020-12-25,2020-12-25,Groceries
40906174,887965,0,-39731393,2020-12-26,2020-12-26,Utilities
40906174,0,656258,-39075135,2020-12-26,2020-12-26,
40906174,941183,0,-40016318,2020-12-27,2020-12-27,Utilities
40906174,596117,0,-40612435,2020-12-27,2020-12-27,Education
40906174,568187,0,-41180622,2020-12-28,2020-12-28,Healthcare
40906174,458279,0,-41638901,2020-12-29,2020-12-29,Utilities
40906174,0,906586,-40732315,2020-12-30,2020-12-30,
40906174,0,463491,-40268824,2020-12-31,2020-12-31,
40906174,0,416340,-39852484,2021-01-01,2021-01-01,
40906174,885106,0,-39867194,2021-01-01,2021-01-01,Education
40906174,851462,0,-40718656,2021-01-02,2021-01-02,Groceries
40906174,0,10285,-40708371,2021-01-03,2021-01-03,
40906174,0,954236,-39754135,2021-01-04,2021-01-04,
40906174,14308,0,-39768443,2021-01-05,2021-01-05,Bill Sharing
40906174,16763,0,-39785206,2021-01-05,2021-01-05,Groceries
40906174,11916,0,-39797122,2021-01-06,2021-01-06,Bill Sharing
40906174,0,601028,-39196094,2021-01-06,2021-01-06,
40906174,995709,0,-40191803,2021-01-07,2021-01-07,Utilities
40906174,0,719995,-39471808,2021-01-07,2021-01-07,
40906174,13727,0,-39485535,2021-01-07,2021-01-07,Transportation
40906174,16553,0,-39502088,2021-01-08,2021-01-08,Healthcare
40906174,0,864000,-38638088,2021-01-09,2021-01-09,
40906174,588347,0,-39226435,2021-01-09,2021-01-09,Rent
40906174,827796,0,-39214338,2021-01-10,2021-01-10,Education
40906174,951350,0,-40165688,2021-01-10,2021-01-10,Clothes
40906174,12230,0,-40177918,2021-01-11,2021-01-11,Transportation
40906174,0,663584,-39514334,2021-01-12,2021-01-12,
40906174,0,793690,-38720644,2021-01-12,2021-01-12,
40906174,860300,0,-39580944,2021-01-12,2021-01-12,Rent
40906174,0,933739,-38647205,2021-01-13,2021-01-13,
40906174,0,794699,-37852506,2021-01-13,2021-01-13,
40906174,0,958876,-36893630,2021-01-14,2021-01-14,
40906174,10305,0,-36903935,2021-01-14,2021-01-14,Education
40906174,524628,0,-37428563,2021-01-15,2021-01-15,Healthcare
40906174,720125,0,-38148688,2021-01-15,2021-01-15,Transportation
40906174,797187,0,-38945875,2021-01-16,2021-01-16,Education
40906174,0,738398,-38207477,2021-01-16,2021-01-16,
40906174,0,967857,-37239620,2021-01-17,2021-01-17,
40906174,632262,0,-37871882,2021-01-17,2021-01-17,Groceries
40906174,0,13998,-37857884,2021-01-18,2021-01-18,
40906174,986133,0,-38844017,2021-01-18,2021-01-18,Transportation
40906174,17670,0,-38861687,2021-01-18,2021-01-18,Entertainment
40906174,0,711711,-38149976,2021-01-19,2021-01-19,
40906174,705568,0,-38631262,2021-01-19,2021-01-19,Education
40906174,0,939567,-37691695,2021-01-20,2021-01-20,
40906174,0,811796,-36879899,2021-01-20,2021-01-20,
40906174,0,10614,-36869285,2021-01-20,2021-01-20,
40906174,14084,0,-36883369,2021-01-21,2021-01-21,Transportation
40906174,0,613918,-36269451,2021-01-21,2021-01-21,
40906174,15456,0,-36284907,2021-01-21,2021-01-21,Transportation
40906174,0,589995,-35694912,2021-01-22,2021-01-22,
40906174,0,12832,-35682080,2021-01-22,2021-01-22,
40906174,827634,0,-36509714,2021-01-23,2021-01-23,Entertainment
40906174,0,468049,-36041665,2021-01-23,2021-01-23,
40906174,881403,0,-36923068,2021-01-24,2021-01-24,Clothes
40906174,650430,0,-37573498,2021-01-25,2021-01-25,Groceries
40906174,629524,0,-38203022,2021-01-26,2021-01-26,Clothes
40906174,0,16876,-38186146,2021-01-26,2021-01-26,
40906174,484745,0,-38670891,2021-01-26,2021-01-26,Groceries
40906174,15455,0,-38686346,2021-01-27,2021-01-27,Utilities
40906174,13242,0,-38699588,2021-01-27,2021-01-27,Bill Sharing
40906174,0,19719,-38679869,2021-01-27,2021-01-27,
40906174,0,14101,-38665768,2021-01-28,2021-01-28,
40906174,0,783765,-37882003,2021-01-29,2021-01-29,
40906174,0,911437,-36970566,2021-01-29,2021-01-29,
40906174,15628,0,-36986194,2021-01-29,2021-01-29,Rent
40906174,0,506856,-36479338,2021-01-30,2021-01-30,
40906174,11404,0,-36490742,2021-01-31,2021-01-31,Transportation
40906174,0,14148,-36476594,2021-01-31,2021-01-31,
40906174,571524,0,-37048118,2021-01-31,2021-01-31,Clothes
40906174,0,748397,-36299721,2021-02-01,2021-02-01,
40906174,0,766374,-35533347,2021-02-01,2021-02-01,
40906174,0,10191,-35523156,2021-02-01,2021-02-01,
40906174,0,992133,-34531023,2021-02-02,2021-02-02,
40906174,18960,0,-34549983,2021-02-02,2021-02-02,Clothes
40906174,0,841523,-33708460,2021-02-02,2021-02-02,
40906174,946412,0,-34654872,2021-02-03,2021-02-03,Rent
40906174,18027,0,-34672899,2021-02-03,2021-02-03,Rent
40906174,871795,0,-35544694,2021-02-04,2021-02-04,Groceries
40906174,458325,0,-36003019,2021-02-04,2021-02-04,Groceries
40906174,16761,0,-36019780,2021-02-05,2021-02-05,Groceries
40906174,12104,0,-36031884,2021-02-06,2021-02-06,Entertainment
40906174,0,568413,-35463471,2021-02-07,2021-02-07,
40906174,452703,0,-35916174,2021-02-08,2021-02-08,Entertainment
40906174,475076,0,-36391250,2021-02-09,2021-02-09,Education
40906174,738929,0,-37130179,2021-02-09,2021-02-09,Entertainment
40906174,0,436932,-36693247,2021-02-10,2021-02-10,
40906174,16660,0,-36709907,2021-02-10,2021-02-10,Groceries
40906174,562919,0,-37272826,2021-02-10,2021-02-10,Clothes
40906174,0,935583,-36723444,2021-02-11,2021-02-11,
40906174,976609,0,-37700053,2021-02-11,2021-02-11,Education
40906174,0,816579,-36883474,2021-02-11,2021-02-11,
40906174,577412,0,-37460886,2021-02-12,2021-02-12,Bill Sharing
40906174,963916,0,-38424802,2021-02-13,2021-02-13,Groceries
40906174,464964,0,-38889766,2021-02-13,2021-02-13,Rent
40906174,0,17585,-38872181,2021-02-13,2021-02-13,
40906174,0,16768,-38855413,2021-02-14,2021-02-14,
40906174,0,479674,-38375739,2021-02-15,2021-02-15,
40906174,676496,0,-39052235,2021-02-15,2021-02-15,Entertainment
40906174,0,562248,-38489987,2021-02-16,2021-02-16,
40906174,960483,0,-39450470,2021-02-17,2021-02-17,Clothes
40906174,11508,0,-39461978,2021-02-17,2021-02-17,Education
40906174,15330,0,-39477308,2021-02-17,2021-02-17,Healthcare
40906174,0,16065,-39461243,2021-02-18,2021-02-18,
40906174,12193,0,-39473436,2021-02-18,2021-02-18,Groceries
40906174,0,843174,-38630262,2021-02-18,2021-02-18,
40906174,0,889594,-37740668,2021-02-19,2021-02-19,
40906174,12608,0,-37753276,2021-02-19,2021-02-19,Education
40906174,12461,0,-37765737,2021-02-20,2021-02-20,Healthcare
40906174,0,511536,-37254201,2021-02-21,2021-02-21,
40906174,831093,0,-38085294,2021-02-22,2021-02-22,Utilities
40906174,858892,0,-38944186,2021-02-22,2021-02-22,Transportation
40906174,753946,0,-39698132,2021-02-23,2021-02-23,Bill Sharing
40906174,0,832173,-38865959,2021-02-23,2021-02-23,
40906174,0,835733,-38030226,2021-02-24,2021-02-24,
40906174,888337,0,-38918563,2021-02-24,2021-02-24,Transportation
40906174,0,18595,-38899968,2021-02-24,2021-02-24,
40906174,604540,0,-39504508,2021-02-25,2021-02-25,Education
40906174,0,517221,-38987287,2021-02-26,2021-02-26,
40906174,0,420363,-38566924,2021-02-27,2021-02-27,
40906174,12436,0,-38579360,2021-02-27,2021-02-27,Bill Sharing
40906174,0,11517,-38567843,2021-02-27,2021-02-27,
40906174,873234,0,-39441077,2021-02-28,2021-02-28,Utilities
40906174,0,449941,-38991136,2021-02-28,2021-02-28,
40906174,917817,0,-39908953,2021-03-01,2021-03-01,Transportation
40906174,0,412614,-39496339,2021-03-02,2021-03-02,
40906174,19237,0,-39515576,2021-03-03,2021-03-03,Entertainment
40906174,16781,0,-39532357,2021-03-04,2021-03-04,Utilities
40906174,17289,0,-39549646,2021-03-04,2021-03-04,Entertainment
40906174,0,832512,-38717134,2021-03-05,2021-03-05,
40906174,0,449375,-38267759,2021-03-05,2021-03-05,
40906174,545982,0,-38813741,2021-03-06,2021-03-06,Groceries
40906174,19507,0,-38833248,2021-03-07,2021-03-07,Transportation
40906174,463738,0,-39296986,2021-03-07,2021-03-07,Rent
40906174,0,15745,-39281241,2021-03-08,2021-03-08,
40906174,0,493184,-38788057,2021-03-09,2021-03-09,
40906174,0,18460,-38769597,2021-03-09,2021-03-09,
40906174,11243,0,-38780840,2021-03-10,2021-03-10,Utilities
40906174,0,881626,-37899214,2021-03-10,2021-03-10,
40906174,19502,0,-37918716,2021-03-10,2021-03-10,Rent
40906174,0,503299,-37415417,2021-03-11,2021-03-11,
40906174,0,913454,-36501963,2021-03-12,2021-03-12,
40906174,0,15675,-36486288,2021-03-12,2021-03-12,
40906174,0,944467,-35541821,2021-03-12,2021-03-12,
40906174,0,704318,-34568860,2021-03-13,2021-03-13,
40906174,804009,0,-35372869,2021-03-13,2021-03-13,Transportation
40906174,0,19151,-35353718,2021-03-14,2021-03-14,
40906174,0,17703,-35336015,2021-03-14,2021-03-14,
40906174,0,13492,-35322523,2021-03-15,2021-03-15,
40906174,11015,0,-35333538,2021-03-16,2021-03-16,Education
40906174,16810,0,-35350348,2021-03-16,2021-03-16,Education
40906174,0,17215,-35333133,2021-03-17,2021-03-17,
40906174,12664,0,-35345797,2021-03-17,2021-03-17,Healthcare
40906174,18672,0,-35364469,2021-03-18,2021-03-18,Utilities
40906174,12637,0,-35377106,2021-03-18,2021-03-18,Healthcare
40906174,0,553657,-34823449,2021-03-19,2021-03-19,
40906174,0,830217,-33993232,2021-03-20,2021-03-20,
40906174,401263,0,-34545278,2021-03-21,2021-03-21,Healthcare
40906174,646128,0,-35191406,2021-03-21,2021-03-21,Clothes
40906174,930038,0,-36121444,2021-03-22,2021-03-22,Rent
40906174,669539,0,-36790983,2021-03-23,2021-03-23,Rent
40906174,0,485981,-36305002,2021-03-23,2021-03-23,
40906174,0,844750,-35460252,2021-03-24,2021-03-24,
40906174,0,990600,-34469652,2021-03-24,2021-03-24,
40906174,635313,0,-35104965,2021-03-24,2021-03-24,Groceries
40906174,0,17000,-35087965,2021-03-25,2021-03-25,
40906174,0,11221,-35076744,2021-03-25,2021-03-25,
40906174,0,18039,-35058705,2021-03-26,2021-03-26,
40906174,0,13826,-35044879,2021-03-27,2021-03-27,
40906174,14531,0,-35059410,2021-03-27,2021-03-27,Groceries
40906174,0,403810,-34655600,2021-03-27,2021-03-27,
40906174,15853,0,-34671453,2021-03-28,2021-03-28,Education
40906174,0,541304,-34130149,2021-03-29,2021-03-29,
40906174,17407,0,-34147556,2021-03-29,2021-03-29,Clothes
40906174,0,483534,-33664022,2021-03-30,2021-03-30,
40906174,558466,0,-34222488,2021-03-30,2021-03-30,Bill Sharing
40906174,14181,0,-34236669,2021-03-30,2021-03-30,Rent
40906174,0,514705,-33721964,2021-03-31,2021-03-31,
40906174,906509,0,-34628473,2021-03-31,2021-03-31,Transportation
40906174,0,777788,-33850685,2021-03-31,2021-03-31,
40906174,0,617946,-34832093,2021-04-01,2021-04-01,
40906174,0,11491,-34820602,2021-04-02,2021-04-02,
40906174,858848,0,-35679450,2021-04-02,2021-04-02,Healthcare
40906174,0,16016,-35663434,2021-04-02,2021-04-02,
40906174,18200,0,-35681634,2021-04-03,2021-04-03,Transportation
40906174,14152,0,-35695786,2021-04-04,2021-04-04,Healthcare
40906174,0,852330,-34843456,2021-04-04,2021-04-04,
40906174,0,18822,-34824634,2021-04-05,2021-04-05,
40906174,0,18532,-34806102,2021-04-05,2021-04-05,
40906174,0,12164,-34793938,2021-04-06,2021-04-06,
40906174,611519,0,-35405457,2021-04-07,2021-04-07,Entertainment
40906174,0,432829,-34972628,2021-04-07,2021-04-07,
40906174,579572,0,-35552200,2021-04-07,2021-04-07,Entertainment
40906174,0,542386,-35009814,2021-04-08,2021-04-08,
40906174,911867,0,-35921681,2021-04-09,2021-04-09,Utilities
40906174,0,840619,-35081062,2021-04-10,2021-04-10,
40906174,0,15327,-35065735,2021-04-11,2021-04-11,
40906174,11907,0,-35077642,2021-04-12,2021-04-12,Utilities
40906174,742782,0,-35820424,2021-04-13,2021-04-13,Utilities
40906174,937968,0,-36758392,2021-04-14,2021-04-14,Education
40906174,19421,0,-36777813,2021-04-15,2021-04-15,Transportation
40906174,18822,0,-36796635,2021-04-15,2021-04-15,Education
40906174,16170,0,-36812805,2021-04-15,2021-04-15,Groceries
40906174,848599,0,-37661404,2021-04-16,2021-04-16,Clothes
40906174,528835,0,-38190239,2021-04-16,2021-04-16,Utilities
40906174,739268,0,-38929507,2021-04-16,2021-04-16,Bill Sharing
40906174,0,571262,-38358245,2021-04-17,2021-04-17,
40906174,749041,0,-39107286,2021-04-17,2021-04-17,Groceries
40906174,0,14796,-39092490,2021-04-17,2021-04-17,
40906174,835108,0,-39927598,2021-04-18,2021-04-18,Groceries
40906174,0,444153,-40646256,2021-04-18,2021-04-18,
40906174,0,10146,-40636110,2021-04-19,2021-04-19,
40906174,522517,0,-41158627,2021-04-20,2021-04-20,Rent
40906174,835863,0,-41994490,2021-04-21,2021-04-21,Entertainment
40906174,14940,0,-42009430,2021-04-21,2021-04-21,Clothes
40906174,430646,0,-42440076,2021-04-21,2021-04-21,Education
40906174,11333,0,-42451409,2021-04-22,2021-04-22,Rent
40906174,844601,0,-43296010,2021-04-22,2021-04-22,Clothes
40906174,977188,0,-44273198,2021-04-22,2021-04-22,Transportation
40906174,0,14065,-44259133,2021-04-23,2021-04-23,
40906174,15421,0,-44274554,2021-04-24,2021-04-24,Entertainment
40906174,530724,0,-44805278,2021-04-24,2021-04-24,Education
40906174,523040,0,-45328318,2021-04-25,2021-04-25,Healthcare
40906174,956236,0,-46284554,2021-04-26,2021-04-26,Groceries
40906174,0,899346,-45385208,2021-04-26,2021-04-26,
40906174,0,19536,-45365672,2021-04-26,2021-04-26,
40906174,0,10606,-45355066,2021-04-27,2021-04-27,
40906174,853716,0,-46208782,2021-04-27,2021-04-27,Utilities
40906174,496988,0,-46705770,2021-04-27,2021-04-27,Clothes
40906174,0,792045,-45913725,2021-04-28,2021-04-28,
40906174,915103,0,-46828828,2021-04-28,2021-04-28,Education
40906174,0,448267,-46380561,2021-04-28,2021-04-28,
40906174,0,910901,-45469660,2021-04-29,2021-04-29,
40906174,444797,0,-45914457,2021-04-29,2021-04-29,Groceries
40906174,716333,0,-46630790,2021-04-29,2021-04-29,Rent
40906174,542066,0,-47172856,2021-04-30,2021-04-30,Bill Sharing
40906174,0,17014,-47155842,2021-05-01,2021-05-01,
40906174,496428,0,-47652270,2021-05-01,2021-05-01,Groceries
40906174,11515,0,-47663785,2021-05-01,2021-05-01,Healthcare
40906174,15714,0,-47679499,2021-05-02,2021-05-02,Utilities
40906174,657455,0,-48336954,2021-05-03,2021-05-03,Healthcare
40906174,692798,0,-49029752,2021-05-03,2021-05-03,Entertainment
40906174,487438,0,-49517190,2021-05-03,2021-05-03,Transportation
40906174,959645,0,-50476835,2021-05-04,2021-05-04,Bill Sharing
40906174,863134,0,-51339969,2021-05-04,2021-05-04,Education
40906174,0,15803,-51324166,2021-05-04,2021-05-04,
40906174,15736,0,-51339902,2021-05-05,2021-05-05,Groceries
40906174,10317,0,-51350219,2021-05-05,2021-05-05,Education
40906174,0,12898,-51337321,2021-05-05,2021-05-05,
40906174,0,18303,-51319018,2021-05-06,2021-05-06,
40906174,12190,0,-51331208,2021-05-07,2021-05-07,Utilities
40906174,660716,0,-51991924,2021-05-08,2021-05-08,Transportation
40906174,936451,0,-52928375,2021-05-08,2021-05-08,Entertainment
40906174,0,11806,-52916569,2021-05-08,2021-05-08,
40906174,0,17390,-52899179,2021-05-09,2021-05-09,
40906174,12364,0,-52911543,2021-05-09,2021-05-09,Rent
40906174,700794,0,-53612337,2021-05-09,2021-05-09,Bill Sharing
40906174,0,19789,-53592548,2021-05-10,2021-05-10,
40906174,0,881768,-52710780,2021-05-11,2021-05-11,
40906174,17439,0,-52728219,2021-05-11,2021-05-11,Clothes
40906174,0,945449,-51782770,2021-05-11,2021-05-11,
40906174,471010,0,-52253780,2021-05-12,2021-05-12,Clothes
40906174,16156,0,-52269936,2021-05-13,2021-05-13,Healthcare
40906174,16381,0,-52286317,2021-05-14,2021-05-14,Utilities
40906174,19094,0,-52305411,2021-05-14,2021-05-14,Bill Sharing
40906174,18218,0,-52323629,2021-05-14,2021-05-14,Entertainment
40906174,0,753005,-51570624,2021-05-15,2021-05-15,
40906174,426595,0,-51997219,2021-05-15,2021-05-15,Transportation
40906174,0,13120,-51984099,2021-05-16,2021-05-16,
40906174,17028,0,-52001127,2021-05-16,2021-05-16,Utilities
40906174,721618,0,-52722745,2021-05-16,2021-05-16,Transportation
40906174,12523,0,-52735268,2021-05-17,2021-05-17,Clothes
40906174,402101,0,-53137369,2021-05-18,2021-05-18,Education
40906174,755683,0,-53893052,2021-05-18,2021-05-18,Rent
40906174,0,486465,-53406587,2021-05-18,2021-05-18,
40906174,455203,0,-53861790,2021-05-19,2021-05-19,Transportation
40906174,582018,0,-54443808,2021-05-19,2021-05-19,Education
40906174,0,11679,-54432129,2021-05-19,2021-05-19,
40906174,0,483308,-53948821,2021-05-20,2021-05-20,
40906174,0,502740,-53156506,2021-05-20,2021-05-20,
40906174,762231,0,-53918737,2021-05-20,2021-05-20,Entertainment
40906174,12062,0,-53930799,2021-05-21,2021-05-21,Entertainment
40906174,18108,0,-53948907,2021-05-22,2021-05-22,Groceries
40906174,510832,0,-54459739,2021-05-22,2021-05-22,Groceries
40906174,0,14692,-54445047,2021-05-23,2021-05-23,
40906174,11459,0,-54456506,2021-05-24,2021-05-24,Entertainment
40906174,17494,0,-54474000,2021-05-24,2021-05-24,Education
40906174,0,999387,-53474613,2021-05-24,2021-05-24,
40906174,0,533314,-52941299,2021-05-25,2021-05-25,
40906174,0,15447,-52925852,2021-05-26,2021-05-26,
40906174,0,808038,-52117814,2021-05-26,2021-05-26,
40906174,504490,0,-52622304,2021-05-26,2021-05-26,Healthcare
40906174,0,557792,-52064512,2021-05-27,2021-05-27,
40906174,17312,0,-52081824,2021-05-27,2021-05-27,Rent
40906174,12834,0,-52094658,2021-05-27,2021-05-27,Healthcare
40906174,0,982428,-51112230,2021-05-28,2021-05-28,
40906174,0,764735,-50347495,2021-05-28,2021-05-28,
40906174,18410,0,-50365905,2021-05-29,2021-05-29,Clothes
40906174,0,12440,-50353465,2021-05-30,2021-05-30,
40906174,0,13823,-50339642,2021-05-30,2021-05-30,
40906174,0,17147,-50322495,2021-05-30,2021-05-30,
40906174,447860,0,-50770355,2021-05-31,2021-05-31,Healthcare
40906174,0,12955,-50757400,2021-05-31,2021-05-31,
40906174,449059,0,-51206459,2021-05-31,2021-05-31,Bill Sharing
40906174,530773,0,-51737232,2021-06-01,2021-06-01,Rent
40906174,999343,0,-51753183,2021-06-02,2021-06-02,Healthcare
40906174,710482,0,-52463665,2021-06-02,2021-06-02,Bill Sharing
40906174,597417,0,-53061082,2021-06-02,2021-06-02,Healthcare
40906174,0,734513,-52326569,2021-06-03,2021-06-03,
40906174,0,413159,-51913410,2021-06-03,2021-06-03,
40906174,0,639959,-51273451,2021-06-04,2021-06-04,
40906174,19872,0,-51293323,2021-06-05,2021-06-05,Utilities
40906174,0,422896,-50870427,2021-06-05,2021-06-05,
40906174,0,976340,-49894087,2021-06-05,2021-06-05,
40906174,12010,0,-49906097,2021-06-06,2021-06-06,Clothes
40906174,0,933128,-48972969,2021-06-06,2021-06-06,
40906174,13918,0,-48986887,2021-06-06,2021-06-06,Education
40906174,549345,0,-49536232,2021-06-07,2021-06-07,Healthcare
40906174,16009,0,-49552241,2021-06-07,2021-06-07,Entertainment
40906174,902013,0,-50454254,2021-06-08,2021-06-08,Transportation
40906174,814855,0,-50914010,2021-06-08,2021-06-08,Healthcare
40906174,578089,0,-51492099,2021-06-09,2021-06-09,Entertainment
40906174,12630,0,-51504729,2021-06-10,2021-06-10,Rent
40906174,0,19089,-51485640,2021-06-11,2021-06-11,
40906174,17423,0,-51503063,2021-06-11,2021-06-11,Rent
40906174,0,10077,-51492986,2021-06-11,2021-06-11,
40906174,0,490304,-51002682,2021-06-12,2021-06-12,
40906174,560781,0,-51563463,2021-06-13,2021-06-13,Education
40906174,0,819318,-50744145,2021-06-13,2021-06-13,
40906174,0,453869,-50290276,2021-06-14,2021-06-14,
40906174,10937,0,-50301213,2021-06-14,2021-06-14,Clothes
40906174,0,628993,-49672220,2021-06-15,2021-06-15,
40906174,594979,0,-48792307,2021-06-15,2021-06-15,Education
40906174,652863,0,-49445170,2021-06-16,2021-06-16,Healthcare
40906174,603155,0,-50048325,2021-06-16,2021-06-16,Groceries
40906174,847511,0,-50895836,2021-06-17,2021-06-17,Clothes
40906174,515013,0,-50908484,2021-06-17,2021-06-17,Healthcare
40906174,0,12222,-50896262,2021-06-18,2021-06-18,
40906174,822749,0,-51719011,2021-06-18,2021-06-18,Utilities
40906174,0,837817,-50881194,2021-06-18,2021-06-18,
40906174,0,720132,-50161062,2021-06-19,2021-06-19,
40906174,0,520838,-49640224,2021-06-19,2021-06-19,
40906174,0,491910,-49148314,2021-06-19,2021-06-19,
40906174,0,981895,-48166419,2021-06-20,2021-06-20,
40906174,0,737724,-47428695,2021-06-20,2021-06-20,
40906174,15332,0,-47444027,2021-06-21,2021-06-21,Rent
40906174,823258,0,-48267285,2021-06-21,2021-06-21,Healthcare
40906174,524473,0,-48791758,2021-06-22,2021-06-22,Groceries
40906174,0,14981,-48776777,2021-06-22,2021-06-22,
40906174,0,921839,-47854938,2021-06-23,2021-06-23,
40906174,13514,0,-47868452,2021-06-24,2021-06-24,Utilities
40906174,0,990991,-46877461,2021-06-24,2021-06-24,
40906174,0,863167,-46014294,2021-06-24,2021-06-24,
40906174,0,18021,-45996273,2021-06-25,2021-06-25,
40906174,0,810834,-45185439,2021-06-26,2021-06-26,
40906174,900556,0,-46085995,2021-06-27,2021-06-27,Bill Sharing
40906174,10858,0,-46096853,2021-06-28,2021-06-28,Entertainment
40906174,410678,0,-46507531,2021-06-28,2021-06-28,Rent
40906174,15762,0,-46523293,2021-06-28,2021-06-28,Clothes
40906174,0,953642,-45569651,2021-06-29,2021-06-29,
40906174,779289,0,-46348940,2021-06-29,2021-06-29,Utilities
40906174,14678,0,-46363618,2021-06-30,2021-06-30,Utilities
40906174,631005,0,-46994623,2021-06-30,2021-06-30,Clothes
40906174,0,859758,-46134865,2021-06-30,2021-06-30,
40906174,654681,0,-46789546,2021-07-01,2021-07-01,Transportation
40906174,0,962332,-45827214,2021-07-02,2021-07-02,
40906174,829390,0,-45810628,2021-07-02,2021-07-02,Healthcare
40906174,0,871929,-45296534,2021-07-02,2021-07-02,
40906174,0,14818,-45281716,2021-07-03,2021-07-03,
40906174,0,812316,-44469400,2021-07-04,2021-07-04,
40906174,12721,0,-44482121,2021-07-04,2021-07-04,Utilities
40906174,614236,0,-45096357,2021-07-05,2021-07-05,Transportation
40906174,0,910825,-44185532,2021-07-06,2021-07-06,
40906174,0,411294,-43774238,2021-07-07,2021-07-07,
40906174,12121,0,-43786359,2021-07-07,2021-07-07,Groceries
40906174,0,584709,-43201650,2021-07-08,2021-07-08,
40906174,0,649361,-42552289,2021-07-08,2021-07-08,
40906174,675609,0,-43227898,2021-07-09,2021-07-09,Groceries
40906174,0,16693,-43211205,2021-07-10,2021-07-10,
40906174,12317,0,-43223522,2021-07-10,2021-07-10,Education
40906174,11211,0,-43234733,2021-07-10,2021-07-10,Education
40906174,0,974859,-42259874,2021-07-11,2021-07-11,
40906174,0,854679,-41405195,2021-07-12,2021-07-12,
40906174,829588,0,-42234783,2021-07-12,2021-07-12,Healthcare
40906174,877567,0,-43112350,2021-07-12,2021-07-12,Clothes
40906174,19756,0,-43132106,2021-07-13,2021-07-13,Healthcare
40906174,0,14072,-43118034,2021-07-14,2021-07-14,
40906174,0,685113,-42432921,2021-07-14,2021-07-14,
40906174,934687,0,-43367608,2021-07-15,2021-07-15,Groceries
40906174,16202,0,-43383810,2021-07-15,2021-07-15,Bill Sharing
40906174,724604,0,-43399686,2021-07-15,2021-07-15,Healthcare
40906174,0,896317,-42503369,2021-07-16,2021-07-16,
40906174,0,422415,-42080954,2021-07-17,2021-07-17,
40906174,978994,0,-42097243,2021-07-18,2021-07-18,Education
40906174,0,10135,-42087108,2021-07-18,2021-07-18,
40906174,0,987220,-41099888,2021-07-19,2021-07-19,
40906174,548636,0,-41648524,2021-07-19,2021-07-19,Transportation
40906174,0,14832,-41633692,2021-07-19,2021-07-19,
40906174,646966,0,-42280658,2021-07-20,2021-07-20,Transportation
40906174,0,526115,-41754543,2021-07-21,2021-07-21,
40906174,0,804308,-40950235,2021-07-21,2021-07-21,
40906174,0,826375,-40483377,2021-07-22,2021-07-22,
40906174,609627,0,-41093004,2021-07-22,2021-07-22,Groceries
40906174,655260,0,-41748264,2021-07-23,2021-07-23,Utilities
40906174,0,995012,-40753252,2021-07-23,2021-07-23,
40906174,821968,0,-41575220,2021-07-23,2021-07-23,Transportation
40906174,0,11651,-41563569,2021-07-24,2021-07-24,
40906174,0,13501,-41550068,2021-07-24,2021-07-24,
40906174,0,666681,-40883387,2021-07-24,2021-07-24,
40906174,761632,0,-41645019,2021-07-25,2021-07-25,Bill Sharing
40906174,0,12078,-41632941,2021-07-25,2021-07-25,
40906174,0,405438,-41227503,2021-07-25,2021-07-25,
40906174,0,411625,-40815878,2021-07-26,2021-07-26,
40906174,0,15257,-40800621,2021-07-26,2021-07-26,
40906174,944615,0,-41745236,2021-07-26,2021-07-26,Rent
40906174,0,516041,-41229195,2021-07-27,2021-07-27,
40906174,455221,0,-41684416,2021-07-28,2021-07-28,Utilities
40906174,0,408428,-41275988,2021-07-29,2021-07-29,
40906174,13031,0,-41289019,2021-07-29,2021-07-29,Transportation
40906174,0,10768,-41278251,2021-07-30,2021-07-30,
40906174,0,19167,-41259084,2021-07-30,2021-07-30,
40906174,0,650867,-40608217,2021-07-30,2021-07-30,
40906174,0,11455,-40596762,2021-07-31,2021-07-31,
40906174,0,17002,-40579760,2021-07-31,2021-07-31,
40906174,15982,0,-40595742,2021-08-01,2021-08-01,Clothes
40906174,0,572242,-40023500,2021-08-02,2021-08-02,
40906174,0,18747,-40004753,2021-08-02,2021-08-02,
40906174,669467,0,-40674220,2021-08-03,2021-08-03,Entertainment
40906174,0,816090,-39858130,2021-08-03,2021-08-03,
40906174,820365,0,-40678495,2021-08-03,2021-08-03,Groceries
40906174,0,14948,-40663547,2021-08-04,2021-08-04,
40906174,648306,0,-41311853,2021-08-05,2021-08-05,Entertainment
40906174,0,969214,-40342639,2021-08-05,2021-08-05,
40906174,836862,0,-41179501,2021-08-06,2021-08-06,Transportation
40906174,0,808220,-40371281,2021-08-06,2021-08-06,
40906174,18919,0,-40390200,2021-08-06,2021-08-06,Education
40906174,10639,0,-40400839,2021-08-07,2021-08-07,Education
40906174,0,572361,-39828478,2021-08-07,2021-08-07,
40906174,0,544574,-39283904,2021-08-08,2021-08-08,
40906174,10906,0,-39294810,2021-08-08,2021-08-08,Bill Sharing
40906174,17703,0,-39312513,2021-08-08,2021-08-08,Healthcare
40906174,854703,0,-40167216,2021-08-09,2021-08-09,Entertainment
40906174,944297,0,-41111513,2021-08-10,2021-08-10,Transportation
40906174,887674,0,-41999187,2021-08-10,2021-08-10,Healthcare
40906174,0,662509,-41336678,2021-08-11,2021-08-11,
40906174,0,15343,-41321335,2021-08-12,2021-08-12,
40906174,0,523618,-40797717,2021-08-13,2021-08-13,
40906174,848557,0,-40813174,2021-08-13,2021-08-13,Healthcare
40906174,797509,0,-41610683,2021-08-13,2021-08-13,Groceries
40906174,0,18573,-41592110,2021-08-14,2021-08-14,
40906174,743527,0,-42335637,2021-08-14,2021-08-14,Bill Sharing
40906174,0,920945,-41414692,2021-08-15,2021-08-15,
40906174,17519,0,-41432211,2021-08-15,2021-08-15,Education
40906174,11166,0,-41443377,2021-08-15,2021-08-15,Groceries
40906174,0,13941,-41429436,2021-08-16,2021-08-16,
40906174,0,472218,-40957218,2021-08-16,2021-08-16,
40906174,755646,0,-41712864,2021-08-16,2021-08-16,Groceries
40906174,0,409594,-41303270,2021-08-17,2021-08-17,
40906174,11175,0,-41314445,2021-08-17,2021-08-17,Healthcare
40906174,864887,0,-41330443,2021-08-17,2021-08-17,Healthcare
40906174,0,14328,-41316115,2021-08-18,2021-08-18,
40906174,628470,0,-41944585,2021-08-18,2021-08-18,Clothes
40906174,0,668958,-41924712,2021-08-18,2021-08-18,
40906174,0,14664,-41910048,2021-08-19,2021-08-19,
40906174,10829,0,-41920877,2021-08-19,2021-08-19,Groceries
40906174,750307,0,-42671184,2021-08-19,2021-08-19,Education
40906174,836406,0,-43507590,2021-08-20,2021-08-20,Utilities
40906174,0,406517,-43101073,2021-08-21,2021-08-21,
40906174,13722,0,-43114795,2021-08-21,2021-08-21,Utilities
40906174,0,408383,-42706412,2021-08-21,2021-08-21,
40906174,0,16107,-42690305,2021-08-22,2021-08-22,
40906174,0,664339,-42025966,2021-08-22,2021-08-22,
40906174,18631,0,-42044597,2021-08-23,2021-08-23,Utilities
40906174,0,797108,-41247489,2021-08-23,2021-08-23,
40906174,0,13385,-41234104,2021-08-24,2021-08-24,
40906174,578874,0,-41812978,2021-08-24,2021-08-24,Education
40906174,0,910146,-40902832,2021-08-25,2021-08-25,
40906174,0,14163,-40888669,2021-08-26,2021-08-26,
40906174,18647,0,-40907316,2021-08-27,2021-08-27,Utilities
40906174,890318,0,-41797634,2021-08-27,2021-08-27,Utilities
40906174,513867,0,-42311501,2021-08-28,2021-08-28,Transportation
40906174,926963,0,-43238464,2021-08-28,2021-08-28,Healthcare
40906174,0,735492,-42502972,2021-08-29,2021-08-29,
40906174,0,938060,-41564912,2021-08-29,2021-08-29,
40906174,855934,0,-42420846,2021-08-29,2021-08-29,Transportation
40906174,0,851722,-41569124,2021-08-30,2021-08-30,
40906174,974740,0,-42543864,2021-08-31,2021-08-31,Transportation
40906174,954073,0,-43497937,2021-09-01,2021-09-01,Clothes
40906174,0,16157,-43481780,2021-09-01,2021-09-01,
40906174,0,19568,-43462212,2021-09-02,2021-09-02,
40906174,0,914558,-42547654,2021-09-02,2021-09-02,
40906174,0,15545,-42532109,2021-09-02,2021-09-02,
40906174,822642,0,-43354751,2021-09-03,2021-09-03,Utilities
40906174,16952,0,-43371703,2021-09-03,2021-09-03,Clothes
40906174,0,16835,-43354868,2021-09-04,2021-09-04,
40906174,416502,0,-43771370,2021-09-05,2021-09-05,Transportation
40906174,0,828736,-44353731,2021-09-06,2021-09-06,
40906174,994473,0,-45348204,2021-09-06,2021-09-06,Transportation
40906174,0,745662,-44602542,2021-09-06,2021-09-06,
40906174,0,12030,-44590512,2021-09-07,2021-09-07,
40906174,0,993111,-43597401,2021-09-07,2021-09-07,
40906174,0,427769,-43169632,2021-09-08,2021-09-08,
40906174,10648,0,-43180280,2021-09-08,2021-09-08,Entertainment
40906174,0,431011,-42749269,2021-09-08,2021-09-08,
40906174,10492,0,-42759761,2021-09-09,2021-09-09,Education
40906174,756374,0,-43516135,2021-09-09,2021-09-09,Transportation
40906174,934998,0,-44451133,2021-09-09,2021-09-09,Transportation
40906174,0,566054,-43885079,2021-09-10,2021-09-10,
40906174,920381,0,-44805460,2021-09-11,2021-09-11,Groceries
40906174,14487,0,-44819947,2021-09-11,2021-09-11,Transportation
40906174,0,420896,-44399051,2021-09-11,2021-09-11,
40906174,699405,0,-45098456,2021-09-12,2021-09-12,Entertainment
40906174,0,12532,-45085924,2021-09-12,2021-09-12,
40906174,0,677150,-44408774,2021-09-13,2021-09-13,
40906174,0,17126,-44391648,2021-09-13,2021-09-13,
40906174,19009,0,-44410657,2021-09-13,2021-09-13,Clothes
40906174,11463,0,-44422120,2021-09-14,2021-09-14,Entertainment
40906174,729368,0,-45151488,2021-09-14,2021-09-14,Transportation
40906174,832735,0,-45984223,2021-09-15,2021-09-15,Bill Sharing
40906174,0,671491,-45312732,2021-09-15,2021-09-15,
40906174,11526,0,-45324258,2021-09-15,2021-09-15,Entertainment
40906174,18356,0,-45342614,2021-09-16,2021-09-16,Groceries
40906174,0,999726,-44342888,2021-09-16,2021-09-16,
40906174,0,467257,-43875631,2021-09-17,2021-09-17,
40906174,0,460900,-43414731,2021-09-18,2021-09-18,
40906174,962576,0,-44377307,2021-09-18,2021-09-18,Clothes
40906174,523865,0,-44901172,2021-09-19,2021-09-19,Groceries
40906174,0,671330,-44229842,2021-09-19,2021-09-19,
40906174,0,681737,-43548105,2021-09-20,2021-09-20,
40906174,0,15267,-43532838,2021-09-20,2021-09-20,
40906174,0,963404,-42569434,2021-09-21,2021-09-21,
40906174,632352,0,-43201786,2021-09-21,2021-09-21,Education
40906174,0,12652,-43189134,2021-09-22,2021-09-22,
40906174,10192,0,-43199326,2021-09-22,2021-09-22,Rent
40906174,0,832242,-42367084,2021-09-22,2021-09-22,
40906174,0,12762,-42354322,2021-09-23,2021-09-23,
40906174,0,15596,-42338726,2021-09-23,2021-09-23,
40906174,0,849770,-41488956,2021-09-23,2021-09-23,
40906174,18249,0,-41507205,2021-09-24,2021-09-24,Education
40906174,903379,0,-42410584,2021-09-24,2021-09-24,Utilities
40906174,0,14828,-42395756,2021-09-25,2021-09-25,
40906174,0,476146,-43172439,2021-09-25,2021-09-25,
40906174,17067,0,-43189506,2021-09-26,2021-09-26,Transportation
40906174,0,19793,-43169713,2021-09-26,2021-09-26,
40906174,0,610890,-42558823,2021-09-27,2021-09-27,
40906174,18915,0,-42577738,2021-09-28,2021-09-28,Healthcare
40906174,779786,0,-43357524,2021-09-29,2021-09-29,Entertainment
40906174,556522,0,-43914046,2021-09-29,2021-09-29,Education
40906174,14270,0,-43928316,2021-09-30,2021-09-30,Clothes
40906174,15226,0,-43943542,2021-09-30,2021-09-30,Rent
40906174,0,817765,-43125777,2021-09-30,2021-09-30,
40906174,15570,0,-43141347,2021-10-01,2021-10-01,Groceries
40906174,0,17995,-43123352,2021-10-02,2021-10-02,
40906174,511217,0,-43634569,2021-10-03,2021-10-03,Healthcare
40906174,11381,0,-43645950,2021-10-03,2021-10-03,Bill Sharing
40906174,0,916890,-42729060,2021-10-04,2021-10-04,
40906174,12099,0,-42741159,2021-10-04,2021-10-04,Healthcare
40906174,619049,0,-43360208,2021-10-04,2021-10-04,Groceries
40906174,806053,0,-44166261,2021-10-05,2021-10-05,Education
40906174,0,803690,-43362571,2021-10-05,2021-10-05,
40906174,0,12711,-43349860,2021-10-05,2021-10-05,
40906174,0,12450,-43337410,2021-10-06,2021-10-06,
40906174,0,13966,-43323444,2021-10-06,2021-10-06,
40906174,0,844255,-42479189,2021-10-07,2021-10-07,
40906174,0,768920,-41710269,2021-10-07,2021-10-07,
40906174,0,506292,-41203977,2021-10-08,2021-10-08,
40906174,603324,0,-41807301,2021-10-09,2021-10-09,Transportation
40906174,0,13360,-41793941,2021-10-10,2021-10-10,
40906174,631459,0,-42425400,2021-10-10,2021-10-10,Healthcare
40906174,11486,0,-42436886,2021-10-10,2021-10-10,Transportation
40906174,0,13861,-42423025,2021-10-11,2021-10-11,
40906174,884079,0,-43307104,2021-10-11,2021-10-11,Entertainment
40906174,0,17136,-43289968,2021-10-11,2021-10-11,
40906174,767039,0,-44057007,2021-10-12,2021-10-12,Transportation
40906174,17097,0,-44074104,2021-10-12,2021-10-12,Bill Sharing
40906174,0,564525,-43509579,2021-10-12,2021-10-12,
40906174,14224,0,-43523803,2021-10-13,2021-10-13,Clothes
40906174,17864,0,-43541667,2021-10-13,2021-10-13,Utilities
40906174,0,702370,-42839297,2021-10-13,2021-10-13,
40906174,13443,0,-42852740,2021-10-14,2021-10-14,Utilities
40906174,0,752970,-42099770,2021-10-14,2021-10-14,
40906174,0,503939,-41595831,2021-10-14,2021-10-14,
40906174,0,13010,-41582821,2021-10-15,2021-10-15,
40906174,0,470469,-41112352,2021-10-16,2021-10-16,
40906174,815086,0,-41519405,2021-10-16,2021-10-16,Healthcare
40906174,784829,0,-42304234,2021-10-16,2021-10-16,Clothes
40906174,13385,0,-42317619,2021-10-17,2021-10-17,Bill Sharing
40906174,10891,0,-42328510,2021-10-17,2021-10-17,Bill Sharing
40906174,17078,0,-42345588,2021-10-18,2021-10-18,Clothes
40906174,18316,0,-42363904,2021-10-18,2021-10-18,Rent
40906174,881128,0,-43245032,2021-10-18,2021-10-18,Bill Sharing
40906174,18697,0,-43263729,2021-10-19,2021-10-19,Education
40906174,0,13822,-43249907,2021-10-20,2021-10-20,
40906174,10918,0,-43260825,2021-10-20,2021-10-20,Rent
40906174,0,19586,-43241239,2021-10-21,2021-10-21,
40906174,964316,0,-43226093,2021-10-21,2021-10-21,Education
40906174,426610,0,-43652703,2021-10-22,2021-10-22,Education
40906174,12188,0,-43664891,2021-10-22,2021-10-22,Bill Sharing
40906174,12271,0,-43677162,2021-10-22,2021-10-22,Clothes
40906174,13529,0,-43690691,2021-10-23,2021-10-23,Rent
40906174,0,10054,-43680637,2021-10-23,2021-10-23,
40906174,579291,0,-44259928,2021-10-24,2021-10-24,Education
40906174,0,17369,-44242559,2021-10-24,2021-10-24,
40906174,425233,0,-44667792,2021-10-25,2021-10-25,Education
40906174,0,690431,-43977361,2021-10-26,2021-10-26,
40906174,716317,0,-44693678,2021-10-27,2021-10-27,Education
40906174,0,19250,-44674428,2021-10-27,2021-10-27,
40906174,17588,0,-44692016,2021-10-28,2021-10-28,Clothes
40906174,0,18173,-44673843,2021-10-29,2021-10-29,
40906174,0,646790,-44027053,2021-10-29,2021-10-29,
40906174,0,427837,-43599216,2021-10-29,2021-10-29,
40906174,416629,0,-44015845,2021-10-30,2021-10-30,Entertainment
40906174,0,17552,-43998293,2021-10-30,2021-10-30,
40906174,0,501786,-43496507,2021-10-30,2021-10-30,
40906174,0,503335,-42993172,2021-10-31,2021-10-31,
40906174,0,932739,-42060433,2021-10-31,2021-10-31,
40906174,606811,0,-42667244,2021-11-01,2021-11-01,Transportation
40906174,0,682985,-41984259,2021-11-02,2021-11-02,
40906174,11760,0,-41996019,2021-11-02,2021-11-02,Entertainment
40906174,17751,0,-42013770,2021-11-03,2021-11-03,Utilities
40906174,0,849993,-41163777,2021-11-04,2021-11-04,
40906174,14942,0,-41178719,2021-11-04,2021-11-04,Healthcare
40906174,0,11154,-41167565,2021-11-04,2021-11-04,
40906174,18102,0,-41185667,2021-11-05,2021-11-05,Groceries
40906174,538145,0,-41723812,2021-11-06,2021-11-06,Groceries
40906174,16791,0,-41740603,2021-11-07,2021-11-07,Clothes
40906174,811126,0,-42551729,2021-11-08,2021-11-08,Clothes
40906174,572398,0,-43124127,2021-11-08,2021-11-08,Entertainment
40906174,0,656991,-42467136,2021-11-08,2021-11-08,
40906174,10578,0,-42477714,2021-11-09,2021-11-09,Education
40906174,14444,0,-42492158,2021-11-10,2021-11-10,Clothes
40906174,0,855187,-41680805,2021-11-10,2021-11-10,
40906174,15730,0,-41696535,2021-11-10,2021-11-10,Entertainment
40906174,712944,0,-42409479,2021-11-11,2021-11-11,Healthcare
40906174,0,16188,-42393291,2021-11-12,2021-11-12,
40906174,484105,0,-42877396,2021-11-12,2021-11-12,Bill Sharing
40906174,506412,0,-43383808,2021-11-12,2021-11-12,Transportation
40906174,0,14411,-43369397,2021-11-13,2021-11-13,
40906174,0,653320,-42716077,2021-11-13,2021-11-13,
40906174,0,14440,-42701637,2021-11-13,2021-11-13,
40906174,0,781393,-41920244,2021-11-14,2021-11-14,
40906174,0,16650,-41903594,2021-11-14,2021-11-14,
40906174,530846,0,-42434440,2021-11-14,2021-11-14,Clothes
40906174,0,13928,-42420512,2021-11-15,2021-11-15,
40906174,0,14593,-42405919,2021-11-15,2021-11-15,
40906174,0,450655,-41955264,2021-11-15,2021-11-15,
40906174,0,827162,-41128102,2021-11-16,2021-11-16,
40906174,0,501764,-40626338,2021-11-17,2021-11-17,
40906174,0,464232,-40162106,2021-11-17,2021-11-17,
40906174,0,418236,-39743870,2021-11-18,2021-11-18,
40906174,897757,0,-40641627,2021-11-18,2021-11-18,Healthcare
40906174,0,13103,-40628524,2021-11-18,2021-11-18,
40906174,553558,0,-41182082,2021-11-19,2021-11-19,Clothes
40906174,497502,0,-41679584,2021-11-19,2021-11-19,Clothes
40906174,0,14356,-41665228,2021-11-19,2021-11-19,
40906174,0,601349,-41063879,2021-11-20,2021-11-20,
40906174,0,835466,-40228413,2021-11-20,2021-11-20,
40906174,0,10313,-40218100,2021-11-20,2021-11-20,
40906174,642196,0,-40860296,2021-11-21,2021-11-21,Utilities
40906174,595903,0,-41456199,2021-11-21,2021-11-21,Entertainment
40906174,0,19138,-41437061,2021-11-21,2021-11-21,
40906174,815565,0,-42252626,2021-11-22,2021-11-22,Utilities
40906174,564568,0,-42817194,2021-11-22,2021-11-22,Entertainment
40906174,0,12187,-42805007,2021-11-23,2021-11-23,
40906174,0,469463,-42335544,2021-11-24,2021-11-24,
40906174,0,12472,-42323072,2021-11-24,2021-11-24,
40906174,0,515107,-41807965,2021-11-24,2021-11-24,
40906174,0,16347,-41791618,2021-11-25,2021-11-25,
40906174,909233,0,-42700851,2021-11-26,2021-11-26,Entertainment
40906174,0,692778,-42008073,2021-11-27,2021-11-27,
40906174,0,15942,-41992131,2021-11-27,2021-11-27,
40906174,0,808641,-41183490,2021-11-27,2021-11-27,
40906174,14829,0,-41198319,2021-11-28,2021-11-28,Healthcare
40906174,0,602840,-40595479,2021-11-29,2021-11-29,
40906174,19970,0,-40615449,2021-11-29,2021-11-29,Healthcare
40906174,969197,0,-41584646,2021-11-29,2021-11-29,Healthcare
40906174,18705,0,-41603351,2021-11-30,2021-11-30,Groceries
40906174,0,972008,-40631343,2021-11-30,2021-11-30,
40906174,622567,0,-41253910,2021-11-30,2021-11-30,Healthcare
40906174,0,16144,-41237766,2021-12-01,2021-12-01,
40906174,0,701788,-40535978,2021-12-01,2021-12-01,
40906174,507110,0,-40555078,2021-12-02,2021-12-02,Healthcare
40906174,0,412961,-40142117,2021-12-03,2021-12-03,
40906174,815411,0,-40957528,2021-12-04,2021-12-04,Utilities
40906174,16189,0,-40973717,2021-12-04,2021-12-04,Utilities
40906174,0,15261,-40958456,2021-12-05,2021-12-05,
40906174,0,983362,-39975094,2021-12-06,2021-12-06,
40906174,0,971669,-39003425,2021-12-07,2021-12-07,
40906174,17445,0,-39020870,2021-12-08,2021-12-08,Entertainment
40906174,581534,0,-39602404,2021-12-09,2021-12-09,Clothes
40906174,664892,0,-40267296,2021-12-10,2021-12-10,Clothes
40906174,850727,0,-41118023,2021-12-10,2021-12-10,Bill Sharing
40906174,0,577758,-40540265,2021-12-10,2021-12-10,
40906174,762897,0,-41303162,2021-12-11,2021-12-11,Healthcare
40906174,848947,0,-42152109,2021-12-11,2021-12-11,Clothes
40906174,11536,0,-42163645,2021-12-11,2021-12-11,Clothes
40906174,488375,0,-42652020,2021-12-12,2021-12-12,Clothes
40906174,0,10665,-42641355,2021-12-13,2021-12-13,
40906174,417714,0,-41860508,2021-12-13,2021-12-13,Education
40906174,0,17098,-41843410,2021-12-14,2021-12-14,
40906174,938771,0,-42782181,2021-12-14,2021-12-14,Clothes
40906174,436610,0,-43218791,2021-12-15,2021-12-15,Clothes
40906174,0,562250,-43833210,2021-12-15,2021-12-15,
40906174,15045,0,-43848255,2021-12-16,2021-12-16,Entertainment
40906174,784340,0,-44632595,2021-12-16,2021-12-16,Healthcare
40906174,662761,0,-45295356,2021-12-16,2021-12-16,Healthcare
40906174,466255,0,-45761611,2021-12-17,2021-12-17,Groceries
40906174,802601,0,-46564212,2021-12-18,2021-12-18,Healthcare
40906174,0,494402,-46069810,2021-12-18,2021-12-18,
40906174,0,825363,-45244447,2021-12-19,2021-12-19,
40906174,0,17292,-45227155,2021-12-19,2021-12-19,
40906174,0,920410,-44306745,2021-12-20,2021-12-20,
40906174,14743,0,-44321488,2021-12-21,2021-12-21,Groceries
40906174,17965,0,-44339453,2021-12-21,2021-12-21,Groceries
40906174,511729,0,-45291471,2021-12-22,2021-12-22,Healthcare
40906174,0,10880,-45280591,2021-12-23,2021-12-23,
40906174,0,814204,-44466387,2021-12-23,2021-12-23,
40906174,11760,0,-44478147,2021-12-23,2021-12-23,Bill Sharing
40906174,0,762647,-43715500,2021-12-24,2021-12-24,
40906174,0,628754,-43086746,2021-12-25,2021-12-25,
40906174,14698,0,-43101444,2021-12-26,2021-12-26,Transportation
40906174,471681,0,-43573125,2021-12-26,2021-12-26,Groceries
40906174,408280,0,-43981405,2021-12-27,2021-12-27,Clothes
40906174,660921,0,-44642326,2021-12-27,2021-12-27,Rent
40906174,0,510502,-44131824,2021-12-28,2021-12-28,
40906174,13246,0,-44145070,2021-12-29,2021-12-29,Education
40906174,0,16854,-44128216,2021-12-29,2021-12-29,
40906174,0,12055,-44116161,2021-12-29,2021-12-29,
40906174,0,651032,-43465129,2021-12-30,2021-12-30,
40906174,0,438857,-43026272,2021-12-30,2021-12-30,
40906174,18241,0,-43044513,2021-12-30,2021-12-30,Education
40906174,0,634762,-42409751,2021-12-31,2021-12-31,
40906174,15486,0,-42425237,2022-01-01,2022-01-01,Rent
40906174,18026,0,-42443263,2022-01-01,2022-01-01,Groceries
40906174,14003,0,-42457266,2022-01-02,2022-01-02,Groceries
40906174,0,428156,-42029110,2022-01-03,2022-01-03,
40906174,0,451558,-41577552,2022-01-04,2022-01-04,
40906174,0,697781,-40879771,2022-01-04,2022-01-04,
40906174,0,447216,-40432555,2022-01-04,2022-01-04,
40906174,913507,0,-41346062,2022-01-05,2022-01-05,Education
40906174,623658,0,-41969720,2022-01-06,2022-01-06,Healthcare
40906174,0,511610,-41458110,2022-01-07,2022-01-07,
40906174,19299,0,-41477409,2022-01-07,2022-01-07,Entertainment
40906174,11814,0,-41489223,2022-01-08,2022-01-08,Healthcare
40906174,0,834533,-40654690,2022-01-08,2022-01-08,
40906174,0,12755,-40641935,2022-01-08,2022-01-08,
40906174,17345,0,-40659280,2022-01-09,2022-01-09,Rent
40906174,533378,0,-41192658,2022-01-09,2022-01-09,Entertainment
40906174,10573,0,-41203231,2022-01-09,2022-01-09,Entertainment
40906174,0,15012,-41188219,2022-01-10,2022-01-10,
40906174,0,581568,-40606651,2022-01-11,2022-01-11,
40906174,802928,0,-41409579,2022-01-11,2022-01-11,Utilities
40906174,0,796618,-40612961,2022-01-12,2022-01-12,
40906174,489408,0,-41102369,2022-01-12,2022-01-12,Utilities
40906174,0,500549,-40601820,2022-01-12,2022-01-12,
40906174,16012,0,-40617832,2022-01-13,2022-01-13,Healthcare
40906174,0,17881,-40599951,2022-01-13,2022-01-13,
40906174,0,16558,-40583393,2022-01-14,2022-01-14,
40906174,10139,0,-40593532,2022-01-15,2022-01-15,Rent
40906174,0,568527,-40025005,2022-01-15,2022-01-15,
40906174,0,12378,-40012627,2022-01-15,2022-01-15,
40906174,15994,0,-40028621,2022-01-16,2022-01-16,Rent
40906174,16460,0,-40045081,2022-01-17,2022-01-17,Transportation
40906174,0,529733,-40059725,2022-01-18,2022-01-18,
40906174,572304,0,-40632029,2022-01-18,2022-01-18,Healthcare
40906174,0,10614,-40621415,2022-01-19,2022-01-19,
40906174,0,14610,-40606805,2022-01-19,2022-01-19,
40906174,986522,0,-41593327,2022-01-19,2022-01-19,Transportation
40906174,705646,0,-42298973,2022-01-20,2022-01-20,Rent
40906174,0,523674,-41775299,2022-01-20,2022-01-20,
40906174,0,19160,-41756139,2022-01-21,2022-01-21,
40906174,0,995766,-40760373,2022-01-21,2022-01-21,
40906174,0,500461,-40259912,2022-01-21,2022-01-21,
40906174,0,11596,-40248316,2022-01-22,2022-01-22,
40906174,0,893939,-39354377,2022-01-23,2022-01-23,
40906174,0,525498,-38828879,2022-01-23,2022-01-23,
40906174,0,11459,-38817420,2022-01-23,2022-01-23,
40906174,0,16095,-38801325,2022-01-24,2022-01-24,
40906174,0,490766,-38310559,2022-01-24,2022-01-24,
40906174,720098,0,-39030657,2022-01-24,2022-01-24,Rent
40906174,0,949159,-38081498,2022-01-25,2022-01-25,
40906174,745442,0,-38826940,2022-01-25,2022-01-25,Rent
40906174,0,622001,-38204939,2022-01-26,2022-01-26,
40906174,0,847824,-37357115,2022-01-26,2022-01-26,
40906174,18821,0,-37375936,2022-01-26,2022-01-26,Healthcare
40906174,0,507344,-36868592,2022-01-27,2022-01-27,
40906174,973862,0,-37842454,2022-01-27,2022-01-27,Healthcare
40906174,607637,0,-38450091,2022-01-27,2022-01-27,Groceries
40906174,17952,0,-38468043,2022-01-28,2022-01-28,Bill Sharing
40906174,16096,0,-38484139,2022-01-28,2022-01-28,Bill Sharing
40906174,0,822921,-39005792,2022-01-29,2022-01-29,
40906174,551907,0,-39557699,2022-01-30,2022-01-30,Utilities
40906174,0,735963,-38821736,2022-01-31,2022-01-31,
40906174,0,939111,-37882625,2022-01-31,2022-01-31,
40906174,15028,0,-37897653,2022-02-01,2022-02-01,Groceries
40906174,555353,0,-38453006,2022-02-01,2022-02-01,Entertainment
40906174,0,12917,-38440089,2022-02-01,2022-02-01,
40906174,0,15486,-38424603,2022-02-02,2022-02-02,
40906174,11642,0,-38436245,2022-02-03,2022-02-03,Education
40906174,0,18269,-38417976,2022-02-03,2022-02-03,
40906174,0,13618,-38404358,2022-02-03,2022-02-03,
40906174,19746,0,-38424104,2022-02-04,2022-02-04,Groceries
40906174,0,10934,-38413170,2022-02-04,2022-02-04,
40906174,13922,0,-38427092,2022-02-05,2022-02-05,Bill Sharing
40906174,16258,0,-38443350,2022-02-06,2022-02-06,Rent
40906174,995209,0,-39438559,2022-02-07,2022-02-07,Entertainment
40906174,0,505552,-38933007,2022-02-07,2022-02-07,
40906174,934691,0,-39867698,2022-02-07,2022-02-07,Groceries
40906174,13318,0,-39881016,2022-02-08,2022-02-08,Bill Sharing
40906174,15832,0,-39896848,2022-02-08,2022-02-08,Bill Sharing
40906174,402201,0,-40299049,2022-02-09,2022-02-09,Utilities
40906174,17783,0,-40316832,2022-02-09,2022-02-09,Healthcare
40906174,0,717529,-39599303,2022-02-10,2022-02-10,
40906174,0,991725,-38607578,2022-02-10,2022-02-10,
40906174,0,11948,-38595630,2022-02-10,2022-02-10,
40906174,17565,0,-38613195,2022-02-11,2022-02-11,Bill Sharing
40906174,0,802772,-37810423,2022-02-11,2022-02-11,
40906174,831211,0,-38641634,2022-02-12,2022-02-12,Utilities
40906174,659155,0,-39300789,2022-02-12,2022-02-12,Entertainment
40906174,695249,0,-39996038,2022-02-12,2022-02-12,Clothes
40906174,528051,0,-40524089,2022-02-13,2022-02-13,Transportation
40906174,0,13802,-40510287,2022-02-13,2022-02-13,
40906174,0,19610,-40490677,2022-02-14,2022-02-14,
40906174,737019,0,-41227696,2022-02-15,2022-02-15,Healthcare
40906174,0,816114,-40411582,2022-02-16,2022-02-16,
40906174,900390,0,-41311972,2022-02-17,2022-02-17,Utilities
40906174,0,977193,-40334779,2022-02-18,2022-02-18,
40906174,0,17062,-40317717,2022-02-19,2022-02-19,
40906174,14645,0,-40332362,2022-02-19,2022-02-19,Clothes
40906174,14839,0,-40347201,2022-02-19,2022-02-19,Clothes
40906174,15089,0,-40362290,2022-02-20,2022-02-20,Rent
40906174,0,528110,-39834180,2022-02-21,2022-02-21,
40906174,17589,0,-39851769,2022-02-21,2022-02-21,Education
40906174,0,477320,-39374449,2022-02-22,2022-02-22,
40906174,0,747593,-38626856,2022-02-22,2022-02-22,
40906174,0,18898,-38607958,2022-02-22,2022-02-22,
40906174,17662,0,-38625620,2022-02-23,2022-02-23,Education
40906174,12241,0,-38637861,2022-02-23,2022-02-23,Entertainment
40906174,0,19934,-38617927,2022-02-23,2022-02-23,
40906174,690931,0,-39308858,2022-02-24,2022-02-24,Clothes
40906174,0,18385,-39290473,2022-02-25,2022-02-25,
40906174,0,18424,-39272049,2022-02-26,2022-02-26,
40906174,0,602451,-38669598,2022-02-26,2022-02-26,
40906174,826190,0,-39495788,2022-02-26,2022-02-26,Healthcare
40906174,434160,0,-39929948,2022-02-27,2022-02-27,Entertainment
40906174,13468,0,-39943416,2022-02-28,2022-02-28,Transportation
40906174,0,702070,-39241346,2022-02-28,2022-02-28,
40906174,0,402597,-38838749,2022-03-01,2022-03-01,
40906174,0,17094,-38821655,2022-03-02,2022-03-02,
40906174,0,728678,-38092977,2022-03-02,2022-03-02,
40906174,0,467611,-37625366,2022-03-02,2022-03-02,
40906174,12985,0,-37638351,2022-03-03,2022-03-03,Groceries
40906174,0,506875,-37131476,2022-03-04,2022-03-04,
40906174,0,717549,-36413927,2022-03-04,2022-03-04,
40906174,0,570300,-35843627,2022-03-05,2022-03-05,
40906174,0,744509,-35825268,2022-03-05,2022-03-05,
40906174,10127,0,-35835395,2022-03-06,2022-03-06,Rent
40906174,12216,0,-35847611,2022-03-06,2022-03-06,Education
40906174,0,894151,-34953460,2022-03-07,2022-03-07,
40906174,0,721178,-34232282,2022-03-07,2022-03-07,
40906174,17345,0,-34249627,2022-03-08,2022-03-08,Healthcare
40906174,921585,0,-35171212,2022-03-08,2022-03-08,Rent
40906174,0,623171,-34548041,2022-03-08,2022-03-08,
40906174,413385,0,-34961426,2022-03-09,2022-03-09,Transportation
40906174,0,529670,-34431756,2022-03-09,2022-03-09,
40906174,0,493336,-33938420,2022-03-10,2022-03-10,
40906174,773506,0,-34711926,2022-03-10,2022-03-10,Education
40906174,10003,0,-34721929,2022-03-10,2022-03-10,Groceries
40906174,588629,0,-35310558,2022-03-11,2022-03-11,Healthcare
40906174,0,562394,-34748164,2022-03-11,2022-03-11,
40906174,17330,0,-34765494,2022-03-12,2022-03-12,Clothes
40906174,638999,0,-35404493,2022-03-12,2022-03-12,Bill Sharing
40906174,0,481314,-34923179,2022-03-12,2022-03-12,
40906174,959546,0,-35882725,2022-03-13,2022-03-13,Groceries
40906174,17792,0,-35900517,2022-03-13,2022-03-13,Entertainment
40906174,0,820604,-35079913,2022-03-14,2022-03-14,
40906174,0,18264,-35061649,2022-03-14,2022-03-14,
40906174,974723,0,-36036372,2022-03-14,2022-03-14,Clothes
40906174,13722,0,-36050094,2022-03-15,2022-03-15,Bill Sharing
40906174,968825,0,-37018919,2022-03-15,2022-03-15,Education
40906174,919621,0,-37938540,2022-03-15,2022-03-15,Bill Sharing
40906174,17966,0,-37956506,2022-03-16,2022-03-16,Groceries
40906174,0,18179,-37938327,2022-03-16,2022-03-16,
40906174,11521,0,-37949848,2022-03-16,2022-03-16,Groceries
40906174,893880,0,-38843728,2022-03-17,2022-03-17,Rent
40906174,18988,0,-38862716,2022-03-17,2022-03-17,Bill Sharing
40906174,0,865814,-37996902,2022-03-18,2022-03-18,
40906174,519524,0,-38516426,2022-03-18,2022-03-18,Utilities
40906174,0,16948,-38499478,2022-03-18,2022-03-18,
40906174,16999,0,-38516477,2022-03-19,2022-03-19,Education
40906174,0,477492,-38038985,2022-03-19,2022-03-19,
40906174,696756,0,-38735741,2022-03-20,2022-03-20,Entertainment
40906174,0,505036,-38230705,2022-03-21,2022-03-21,
40906174,818029,0,-39048734,2022-03-21,2022-03-21,Healthcare
40906174,0,414885,-38633849,2022-03-22,2022-03-22,
40906174,16342,0,-38650191,2022-03-23,2022-03-23,Entertainment
40906174,475923,0,-39126114,2022-03-23,2022-03-23,Groceries
40906174,0,17203,-39108911,2022-03-24,2022-03-24,
40906174,0,11806,-39097105,2022-03-25,2022-03-25,
40906174,0,541043,-38556062,2022-03-26,2022-03-26,
40906174,12119,0,-38568181,2022-03-27,2022-03-27,Education
40906174,830782,0,-39398963,2022-03-27,2022-03-27,Groceries
40906174,561287,0,-39960250,2022-03-27,2022-03-27,Education
40906174,0,11588,-39948662,2022-03-28,2022-03-28,
40906174,0,13906,-39934756,2022-03-28,2022-03-28,
40906174,0,731279,-39203477,2022-03-28,2022-03-28,
40906174,671866,0,-39875343,2022-03-29,2022-03-29,Rent
40906174,0,12097,-39863246,2022-03-30,2022-03-30,
40906174,0,13453,-39849793,2022-03-30,2022-03-30,
40906174,0,403701,-39446092,2022-03-31,2022-03-31,
40906174,0,992924,-38453168,2022-03-31,2022-03-31,
40906174,0,697977,-37590119,2022-04-01,2022-04-01,
40906174,993239,0,-38583358,2022-04-02,2022-04-02,Rent
40906174,0,786884,-37796474,2022-04-03,2022-04-03,
40906174,0,662897,-37133577,2022-04-03,2022-04-03,
40906174,15252,0,-37148829,2022-04-04,2022-04-04,Rent
40906174,0,451965,-36696864,2022-04-04,2022-04-04,
40906174,552545,0,-37249409,2022-04-04,2022-04-04,Bill Sharing
40906174,576984,0,-37826393,2022-04-05,2022-04-05,Entertainment
40906174,16503,0,-37842896,2022-04-06,2022-04-06,Clothes
40906174,511144,0,-38354040,2022-04-06,2022-04-06,Education
40906174,0,810907,-38340856,2022-04-06,2022-04-06,
40906174,0,12148,-38328708,2022-04-07,2022-04-07,
40906174,826113,0,-39154821,2022-04-07,2022-04-07,Entertainment
40906174,0,530956,-38623865,2022-04-07,2022-04-07,
40906174,603964,0,-39227829,2022-04-08,2022-04-08,Transportation
40906174,479818,0,-39707647,2022-04-09,2022-04-09,Education
40906174,0,946767,-38760880,2022-04-10,2022-04-10,
40906174,989482,0,-39750362,2022-04-10,2022-04-10,Groceries
40906174,816618,0,-40566980,2022-04-10,2022-04-10,Bill Sharing
40906174,0,837347,-39729633,2022-04-11,2022-04-11,
40906174,0,17270,-39712363,2022-04-12,2022-04-12,
40906174,0,17454,-39694909,2022-04-12,2022-04-12,
40906174,0,680606,-39014303,2022-04-13,2022-04-13,
40906174,13600,0,-39027903,2022-04-13,2022-04-13,Rent
40906174,655295,0,-39683198,2022-04-13,2022-04-13,Entertainment
40906174,0,14539,-39668659,2022-04-14,2022-04-14,
40906174,19872,0,-39688531,2022-04-14,2022-04-14,Education
40906174,0,15298,-39673233,2022-04-14,2022-04-14,
40906174,0,11839,-39661394,2022-04-15,2022-04-15,
40906174,0,12500,-39648894,2022-04-15,2022-04-15,
40906174,591252,0,-40188078,2022-04-16,2022-04-16,Education
40906174,0,588450,-39599628,2022-04-16,2022-04-16,
40906174,0,614240,-38985388,2022-04-16,2022-04-16,
40906174,0,406447,-38578941,2022-04-17,2022-04-17,
40906174,0,13440,-38565501,2022-04-17,2022-04-17,
40906174,10104,0,-38575605,2022-04-17,2022-04-17,Education
40906174,0,536317,-38039288,2022-04-18,2022-04-18,
40906174,0,16273,-38023015,2022-04-18,2022-04-18,
40906174,0,17310,-38005705,2022-04-18,2022-04-18,
40906174,0,14690,-37991015,2022-04-19,2022-04-19,
40906174,0,10474,-37980541,2022-04-19,2022-04-19,
40906174,0,16792,-37963749,2022-04-20,2022-04-20,
40906174,865443,0,-37947612,2022-04-20,2022-04-20,Education
40906174,12051,0,-37959663,2022-04-21,2022-04-21,Entertainment
40906174,0,582004,-37377659,2022-04-21,2022-04-21,
40906174,12669,0,-37390328,2022-04-22,2022-04-22,Utilities
40906174,916877,0,-38307205,2022-04-23,2022-04-23,Utilities
40906174,16470,0,-38323675,2022-04-23,2022-04-23,Entertainment
40906174,13100,0,-38336775,2022-04-24,2022-04-24,Entertainment
40906174,17528,0,-38354303,2022-04-24,2022-04-24,Education
40906174,935773,0,-39290076,2022-04-24,2022-04-24,Bill Sharing
40906174,17051,0,-39307127,2022-04-25,2022-04-25,Clothes
40906174,0,774280,-38532847,2022-04-25,2022-04-25,
40906174,0,10369,-38522478,2022-04-26,2022-04-26,
40906174,16629,0,-38539107,2022-04-26,2022-04-26,Groceries
40906174,14968,0,-38554075,2022-04-27,2022-04-27,Transportation
40906174,0,718152,-37835923,2022-04-28,2022-04-28,
40906174,0,11463,-37824460,2022-04-28,2022-04-28,
40906174,0,400109,-37424351,2022-04-28,2022-04-28,
40906174,0,11379,-37412972,2022-04-29,2022-04-29,
40906174,0,736609,-36676363,2022-04-30,2022-04-30,
40906174,0,829402,-35846961,2022-04-30,2022-04-30,
40906174,0,11541,-35835420,2022-04-30,2022-04-30,
40906174,19087,0,-35854507,2022-05-01,2022-05-01,Education
40906174,13744,0,-35868251,2022-05-01,2022-05-01,Bill Sharing
40906174,0,18036,-35850215,2022-05-01,2022-05-01,
40906174,10257,0,-35860472,2022-05-02,2022-05-02,Healthcare
40906174,0,15280,-35845192,2022-05-02,2022-05-02,
40906174,12960,0,-35858152,2022-05-02,2022-05-02,Entertainment
40906174,0,435757,-35422395,2022-05-03,2022-05-03,
40906174,504028,0,-35926423,2022-05-04,2022-05-04,Bill Sharing
40906174,812009,0,-36738432,2022-05-04,2022-05-04,Education
40906174,0,17048,-36721384,2022-05-04,2022-05-04,
40906174,960733,0,-37682117,2022-05-05,2022-05-05,Utilities
40906174,556597,0,-38238714,2022-05-06,2022-05-06,Utilities
40906174,684757,0,-38923471,2022-05-06,2022-05-06,Groceries
40906174,19250,0,-38942721,2022-05-06,2022-05-06,Utilities
40906174,0,11882,-38930839,2022-05-07,2022-05-07,
40906174,0,896116,-38034723,2022-05-08,2022-05-08,
40906174,0,402329,-37632394,2022-05-08,2022-05-08,
40906174,17584,0,-37649978,2022-05-09,2022-05-09,Transportation
40906174,0,957562,-36692416,2022-05-09,2022-05-09,
40906174,0,774484,-35917932,2022-05-09,2022-05-09,
40906174,16888,0,-35934820,2022-05-10,2022-05-10,Groceries
40906174,0,647959,-35286861,2022-05-11,2022-05-11,
40906174,0,18464,-35268397,2022-05-11,2022-05-11,
40906174,0,15391,-35253006,2022-05-11,2022-05-11,
40906174,0,893404,-34359602,2022-05-12,2022-05-12,
40906174,0,10463,-34349139,2022-05-12,2022-05-12,
40906174,0,662932,-33686207,2022-05-12,2022-05-12,
40906174,0,708306,-32977901,2022-05-13,2022-05-13,
40906174,14627,0,-32992528,2022-05-13,2022-05-13,Healthcare
40906174,0,15437,-32977091,2022-05-14,2022-05-14,
40906174,0,13991,-32963100,2022-05-14,2022-05-14,
40906174,932122,0,-33895222,2022-05-15,2022-05-15,Education
40906174,0,13946,-33881276,2022-05-15,2022-05-15,
40906174,0,749491,-33131785,2022-05-15,2022-05-15,
40906174,0,12342,-33119443,2022-05-16,2022-05-16,
40906174,0,16434,-33103009,2022-05-16,2022-05-16,
40906174,17962,0,-33120971,2022-05-16,2022-05-16,Rent
40906174,826849,0,-33947820,2022-05-17,2022-05-17,Entertainment
40906174,842085,0,-34789905,2022-05-18,2022-05-18,Clothes
40906174,433999,0,-35223904,2022-05-18,2022-05-18,Education
40906174,0,13645,-35210259,2022-05-19,2022-05-19,
40906174,418309,0,-35628568,2022-05-19,2022-05-19,Healthcare
40906174,17076,0,-35645644,2022-05-20,2022-05-20,Groceries
40906174,18044,0,-35663688,2022-05-20,2022-05-20,Groceries
40906174,455181,0,-36118869,2022-05-21,2022-05-21,Utilities
40906174,0,611107,-35507762,2022-05-22,2022-05-22,
40906174,11355,0,-35519117,2022-05-23,2022-05-23,Healthcare
40906174,690303,0,-36209420,2022-05-24,2022-05-24,Clothes
40906174,0,948102,-35261318,2022-05-24,2022-05-24,
40906174,0,490217,-34771101,2022-05-24,2022-05-24,
40906174,0,479554,-34291547,2022-05-25,2022-05-25,
40906174,912847,0,-35204394,2022-05-25,2022-05-25,Bill Sharing
40906174,0,796005,-34408389,2022-05-25,2022-05-25,
40906174,0,499022,-33909367,2022-05-26,2022-05-26,
40906174,0,752575,-33156792,2022-05-27,2022-05-27,
40906174,12575,0,-33169367,2022-05-28,2022-05-28,Transportation
40906174,0,546496,-32622871,2022-05-29,2022-05-29,
40906174,0,662528,-31960343,2022-05-29,2022-05-29,
40906174,0,16658,-31943685,2022-05-29,2022-05-29,
40906174,19767,0,-31963452,2022-05-30,2022-05-30,Clothes
40906174,0,18870,-31944582,2022-05-30,2022-05-30,
40906174,0,895716,-31048866,2022-05-31,2022-05-31,
40906174,956894,0,-32005760,2022-05-31,2022-05-31,Rent
40906174,0,11676,-31994084,2022-06-01,2022-06-01,
40906174,803495,0,-32797579,2022-06-01,2022-06-01,Healthcare
40906174,0,16546,-32781033,2022-06-01,2022-06-01,
40906174,893763,0,-33674796,2022-06-02,2022-06-02,Transportation
40906174,10054,0,-33684850,2022-06-03,2022-06-03,Transportation
40906174,798644,0,-34483494,2022-06-04,2022-06-04,Utilities
40906174,886657,0,-35370151,2022-06-04,2022-06-04,Bill Sharing
40906174,17902,0,-35388053,2022-06-04,2022-06-04,Transportation
40906174,0,811579,-34576474,2022-06-05,2022-06-05,
40906174,15764,0,-34592238,2022-06-05,2022-06-05,Healthcare
40906174,14084,0,-34606322,2022-06-06,2022-06-06,Healthcare
40906174,12814,0,-34619136,2022-06-06,2022-06-06,Clothes
40906174,15275,0,-34634411,2022-06-07,2022-06-07,Education
40906174,10321,0,-34644732,2022-06-07,2022-06-07,Transportation
40906174,0,651856,-33992876,2022-06-07,2022-06-07,
40906174,0,411935,-33580941,2022-06-08,2022-06-08,
40906174,19793,0,-33600734,2022-06-09,2022-06-09,Entertainment
40906174,588873,0,-34189607,2022-06-10,2022-06-10,Entertainment
40906174,920956,0,-35110563,2022-06-10,2022-06-10,Rent
40906174,609288,0,-35719851,2022-06-11,2022-06-11,Rent
40906174,0,417436,-35302415,2022-06-11,2022-06-11,
40906174,0,15223,-35287192,2022-06-12,2022-06-12,
40906174,10290,0,-35297482,2022-06-12,2022-06-12,Clothes
40906174,877956,0,-36175438,2022-06-12,2022-06-12,Bill Sharing
40906174,0,15163,-36160275,2022-06-13,2022-06-13,
40906174,19925,0,-36180200,2022-06-13,2022-06-13,Utilities
40906174,477859,0,-36658059,2022-06-14,2022-06-14,Clothes
40906174,655022,0,-36235223,2022-06-14,2022-06-14,Healthcare
40906174,812369,0,-37047592,2022-06-15,2022-06-15,Rent
40906174,0,822213,-36225379,2022-06-15,2022-06-15,
40906174,17087,0,-36242466,2022-06-15,2022-06-15,Clothes
40906174,0,757162,-35485304,2022-06-16,2022-06-16,
40906174,0,661094,-34824210,2022-06-17,2022-06-17,
40906174,608468,0,-34806636,2022-06-18,2022-06-18,Education
40906174,592042,0,-35398678,2022-06-18,2022-06-18,Entertainment
40906174,923215,0,-36321893,2022-06-19,2022-06-19,Transportation
40906174,0,745861,-35576032,2022-06-19,2022-06-19,
40906174,0,15891,-35560141,2022-06-19,2022-06-19,
40906174,14091,0,-35574232,2022-06-20,2022-06-20,Groceries
40906174,0,601984,-34972248,2022-06-20,2022-06-20,
40906174,827289,0,-35799537,2022-06-20,2022-06-20,Clothes
40906174,506995,0,-36306532,2022-06-21,2022-06-21,Rent
40906174,0,503101,-35803431,2022-06-21,2022-06-21,
40906174,556684,0,-36360115,2022-06-21,2022-06-21,Rent
40906174,0,10200,-36349915,2022-06-22,2022-06-22,
40906174,675625,0,-37025540,2022-06-22,2022-06-22,Rent
40906174,743438,0,-37768978,2022-06-23,2022-06-23,Education
40906174,0,533969,-37235009,2022-06-24,2022-06-24,
40906174,0,587390,-36647619,2022-06-24,2022-06-24,
40906174,10028,0,-36657647,2022-06-24,2022-06-24,Education
40906174,533121,0,-37190768,2022-06-25,2022-06-25,Transportation
40906174,0,980119,-36342560,2022-06-25,2022-06-25,
40906174,11630,0,-36354190,2022-06-25,2022-06-25,Rent
40906174,636719,0,-36990909,2022-06-26,2022-06-26,Utilities
40906174,0,464058,-36526851,2022-06-27,2022-06-27,
40906174,0,13447,-36513404,2022-06-28,2022-06-28,
40906174,18568,0,-36531972,2022-06-29,2022-06-29,Education
40906174,0,992669,-35539303,2022-06-30,2022-06-30,
40906174,0,17309,-35521994,2022-07-01,2022-07-01,
40906174,461483,0,-35983477,2022-07-01,2022-07-01,Education
40906174,0,10601,-35972876,2022-07-02,2022-07-02,
40906174,978824,0,-35322206,2022-07-02,2022-07-02,Healthcare
40906174,0,423918,-34898288,2022-07-02,2022-07-02,
40906174,19198,0,-34917486,2022-07-03,2022-07-03,Rent
40906174,928449,0,-35845935,2022-07-03,2022-07-03,Healthcare
40906174,11759,0,-35857694,2022-07-04,2022-07-04,Groceries
40906174,0,15945,-35841749,2022-07-04,2022-07-04,
40906174,0,576307,-35265442,2022-07-05,2022-07-05,
40906174,961087,0,-36226529,2022-07-05,2022-07-05,Rent
40906174,0,15500,-36211029,2022-07-05,2022-07-05,
40906174,0,13430,-36197599,2022-07-06,2022-07-06,
40906174,0,17520,-36180079,2022-07-06,2022-07-06,
40906174,444931,0,-36625010,2022-07-07,2022-07-07,Healthcare
40906174,0,15155,-36609855,2022-07-07,2022-07-07,
40906174,0,13695,-36596160,2022-07-07,2022-07-07,
40906174,0,17466,-36578694,2022-07-08,2022-07-08,
40906174,515162,0,-37093856,2022-07-08,2022-07-08,Rent
40906174,0,11275,-37082581,2022-07-09,2022-07-09,
40906174,0,10946,-37071635,2022-07-09,2022-07-09,
40906174,969678,0,-37587272,2022-07-10,2022-07-10,Healthcare
40906174,11670,0,-37598942,2022-07-10,2022-07-10,Groceries
40906174,0,12497,-37586445,2022-07-10,2022-07-10,
40906174,0,529452,-37056993,2022-07-11,2022-07-11,
40906174,17476,0,-37074469,2022-07-11,2022-07-11,Transportation
40906174,576196,0,-37650665,2022-07-11,2022-07-11,Clothes
40906174,14622,0,-37665287,2022-07-12,2022-07-12,Transportation
40906174,0,10919,-37654368,2022-07-12,2022-07-12,
40906174,784940,0,-38439308,2022-07-12,2022-07-12,Bill Sharing
40906174,819182,0,-39258490,2022-07-13,2022-07-13,Utilities
40906174,0,605800,-38652690,2022-07-13,2022-07-13,
40906174,0,15400,-38637290,2022-07-14,2022-07-14,
40906174,0,507884,-38129406,2022-07-15,2022-07-15,
40906174,0,15260,-38114146,2022-07-15,2022-07-15,
40906174,10006,0,-38124152,2022-07-15,2022-07-15,Clothes
40906174,0,682768,-37441384,2022-07-16,2022-07-16,
40906174,0,794814,-36646570,2022-07-16,2022-07-16,
40906174,0,968748,-36632063,2022-07-16,2022-07-16,
40906174,0,18281,-36613782,2022-07-17,2022-07-17,
40906174,0,13990,-36599792,2022-07-18,2022-07-18,
40906174,683256,0,-37283048,2022-07-19,2022-07-19,Healthcare
40906174,0,17145,-37265903,2022-07-19,2022-07-19,
40906174,0,12726,-37253177,2022-07-19,2022-07-19,
40906174,0,824243,-36428934,2022-07-20,2022-07-20,
40906174,0,15785,-36413149,2022-07-21,2022-07-21,
40906174,0,970553,-35537062,2022-07-21,2022-07-21,
40906174,791353,0,-36328415,2022-07-21,2022-07-21,Healthcare
40906174,12075,0,-36340490,2022-07-22,2022-07-22,Bill Sharing
40906174,905772,0,-37246262,2022-07-22,2022-07-22,Clothes
40906174,629228,0,-37875490,2022-07-23,2022-07-23,Healthcare
40906174,0,16032,-37859458,2022-07-23,2022-07-23,
40906174,0,853561,-37005897,2022-07-24,2022-07-24,
40906174,0,894896,-36111001,2022-07-25,2022-07-25,
40906174,0,881784,-35229217,2022-07-25,2022-07-25,
40906174,952580,0,-36181797,2022-07-26,2022-07-26,Transportation
40906174,733971,0,-36915768,2022-07-26,2022-07-26,Transportation
40906174,746585,0,-36104973,2022-07-27,2022-07-27,Education
40906174,755267,0,-36860240,2022-07-27,2022-07-27,Transportation
40906174,0,663780,-36196460,2022-07-28,2022-07-28,
40906174,520243,0,-36716703,2022-07-29,2022-07-29,Rent
40906174,495107,0,-37211810,2022-07-30,2022-07-30,Utilities
40906174,587453,0,-37799263,2022-07-31,2022-07-31,Education
40906174,0,537156,-37262107,2022-08-01,2022-08-01,
40906174,0,13611,-37248496,2022-08-01,2022-08-01,
40906174,749316,0,-37997812,2022-08-02,2022-08-02,Healthcare
40906174,10808,0,-38008620,2022-08-03,2022-08-03,Transportation
40906174,0,14868,-37993752,2022-08-04,2022-08-04,
40906174,0,881420,-37112332,2022-08-04,2022-08-04,
40906174,16580,0,-37128912,2022-08-04,2022-08-04,Rent
40906174,14204,0,-37143116,2022-08-05,2022-08-05,Utilities
40906174,0,14681,-37128435,2022-08-05,2022-08-05,
40906174,13445,0,-37141880,2022-08-06,2022-08-06,Education
40906174,0,10288,-37131592,2022-08-06,2022-08-06,
40906174,15061,0,-37146653,2022-08-07,2022-08-07,Utilities
40906174,0,749197,-36397456,2022-08-07,2022-08-07,
40906174,0,873553,-35523903,2022-08-08,2022-08-08,
40906174,992832,0,-34878724,2022-08-08,2022-08-08,Education
40906174,0,588235,-34290489,2022-08-09,2022-08-09,
40906174,0,15509,-34274980,2022-08-09,2022-08-09,
40906174,738044,0,-35013024,2022-08-10,2022-08-10,Healthcare
40906174,12613,0,-35025637,2022-08-11,2022-08-11,Clothes
40906174,0,19083,-35006554,2022-08-11,2022-08-11,
40906174,464188,0,-35470742,2022-08-11,2022-08-11,Clothes
40906174,0,14116,-35456626,2022-08-12,2022-08-12,
40906174,11081,0,-35467707,2022-08-13,2022-08-13,Utilities
40906174,0,19649,-35448058,2022-08-14,2022-08-14,
40906174,0,11000,-35437058,2022-08-15,2022-08-15,
40906174,814822,0,-36251880,2022-08-16,2022-08-16,Clothes
40906174,15476,0,-36267356,2022-08-17,2022-08-17,Utilities
40906174,674535,0,-36941891,2022-08-17,2022-08-17,Groceries
40906174,0,533508,-36408383,2022-08-18,2022-08-18,
40906174,959876,0,-37368259,2022-08-18,2022-08-18,Healthcare
40906174,0,614475,-37357091,2022-08-19,2022-08-19,
40906174,857353,0,-38214444,2022-08-19,2022-08-19,Groceries
40906174,0,16127,-38198317,2022-08-20,2022-08-20,
40906174,0,814232,-37384085,2022-08-20,2022-08-20,
40906174,0,524318,-36859767,2022-08-21,2022-08-21,
40906174,0,14607,-36845160,2022-08-22,2022-08-22,
40906174,0,17122,-36828038,2022-08-23,2022-08-23,
40906174,0,15883,-36812155,2022-08-23,2022-08-23,
40906174,493244,0,-37305399,2022-08-23,2022-08-23,Clothes
40906174,0,439660,-37317426,2022-08-24,2022-08-24,
40906174,0,689787,-36627639,2022-08-24,2022-08-24,
40906174,10635,0,-36638274,2022-08-24,2022-08-24,Healthcare
40906174,10754,0,-36649028,2022-08-25,2022-08-25,Healthcare
40906174,0,909229,-35739799,2022-08-26,2022-08-26,
40906174,19833,0,-35759632,2022-08-26,2022-08-26,Entertainment
40906174,19805,0,-35779437,2022-08-26,2022-08-26,Healthcare
40906174,0,416617,-35362820,2022-08-27,2022-08-27,
40906174,992719,0,-34543545,2022-08-28,2022-08-28,Healthcare
40906174,988695,0,-34529913,2022-08-29,2022-08-29,Education
40906174,741563,0,-35271476,2022-08-29,2022-08-29,Clothes
40906174,17093,0,-35288569,2022-08-30,2022-08-30,Clothes
40906174,867011,0,-34682147,2022-08-30,2022-08-30,Education
40906174,0,10392,-34671755,2022-08-30,2022-08-30,
40906174,688069,0,-35359824,2022-08-31,2022-08-31,Groceries
40906174,0,613933,-34745891,2022-08-31,2022-08-31,
40906174,11800,0,-34757691,2022-08-31,2022-08-31,Transportation
40906174,543675,0,-35301366,2022-09-01,2022-09-01,Utilities
40906174,13283,0,-35314649,2022-09-01,2022-09-01,Healthcare
40906174,12453,0,-35327102,2022-09-02,2022-09-02,Education
40906174,0,13506,-35313596,2022-09-02,2022-09-02,
40906174,0,14607,-35298989,2022-09-02,2022-09-02,
40906174,0,10205,-35288784,2022-09-03,2022-09-03,
40906174,0,18282,-35270502,2022-09-04,2022-09-04,
40906174,11203,0,-35281705,2022-09-04,2022-09-04,Bill Sharing
40906174,18704,0,-35300409,2022-09-05,2022-09-05,Rent
40906174,448820,0,-35749229,2022-09-05,2022-09-05,Groceries
40906174,0,10578,-35738651,2022-09-06,2022-09-06,
40906174,836571,0,-36575222,2022-09-06,2022-09-06,Transportation
40906174,18838,0,-36594060,2022-09-06,2022-09-06,Bill Sharing
40906174,11511,0,-36605571,2022-09-07,2022-09-07,Entertainment
40906174,14682,0,-36620253,2022-09-07,2022-09-07,Entertainment
40906174,11814,0,-36632067,2022-09-07,2022-09-07,Clothes
40906174,976004,0,-37608071,2022-09-08,2022-09-08,Groceries
40906174,0,829388,-36778683,2022-09-08,2022-09-08,
40906174,17414,0,-36796097,2022-09-08,2022-09-08,Entertainment
40906174,403754,0,-37199851,2022-09-09,2022-09-09,Transportation
40906174,0,11043,-37188808,2022-09-09,2022-09-09,
40906174,0,947703,-36241105,2022-09-09,2022-09-09,
40906174,967286,0,-37208391,2022-09-10,2022-09-10,Healthcare
40906174,19009,0,-37227400,2022-09-10,2022-09-10,Groceries
40906174,923430,0,-38150830,2022-09-10,2022-09-10,Clothes
40906174,0,19834,-38130996,2022-09-11,2022-09-11,
40906174,0,984261,-37146735,2022-09-12,2022-09-12,
40906174,427383,0,-37574118,2022-09-12,2022-09-12,Transportation
40906174,851376,0,-38425494,2022-09-12,2022-09-12,Entertainment
40906174,496594,0,-38922088,2022-09-13,2022-09-13,Entertainment
40906174,0,15119,-38906969,2022-09-13,2022-09-13,
40906174,931943,0,-39838912,2022-09-13,2022-09-13,Clothes
40906174,0,10159,-39828753,2022-09-14,2022-09-14,
40906174,12592,0,-39841345,2022-09-15,2022-09-15,Transportation
40906174,0,19894,-39821451,2022-09-16,2022-09-16,
40906174,0,870383,-38951068,2022-09-16,2022-09-16,
40906174,0,16382,-38934686,2022-09-17,2022-09-17,
40906174,10982,0,-38945668,2022-09-17,2022-09-17,Education
40906174,0,17759,-38927909,2022-09-18,2022-09-18,
40906174,644091,0,-39572000,2022-09-18,2022-09-18,Clothes
40906174,707167,0,-40279167,2022-09-19,2022-09-19,Healthcare
40906174,633044,0,-40297138,2022-09-19,2022-09-19,Healthcare
40906174,0,406208,-39890930,2022-09-20,2022-09-20,
40906174,11252,0,-39902182,2022-09-20,2022-09-20,Bill Sharing
40906174,996771,0,-40898953,2022-09-20,2022-09-20,Transportation
40906174,0,686850,-40212103,2022-09-21,2022-09-21,
40906174,0,18137,-40193966,2022-09-21,2022-09-21,
40906174,626657,0,-40820623,2022-09-21,2022-09-21,Bill Sharing
40906174,465126,0,-41285749,2022-09-22,2022-09-22,Education
40906174,15823,0,-41301572,2022-09-22,2022-09-22,Utilities
40906174,0,19340,-41282232,2022-09-22,2022-09-22,
40906174,19549,0,-41301781,2022-09-23,2022-09-23,Rent
40906174,14044,0,-41315825,2022-09-23,2022-09-23,Education
40906174,0,596695,-40719130,2022-09-24,2022-09-24,
40906174,524842,0,-41243972,2022-09-25,2022-09-25,Transportation
40906174,0,957169,-40286803,2022-09-25,2022-09-25,
40906174,958946,0,-41245749,2022-09-25,2022-09-25,Education
40906174,491864,0,-41737613,2022-09-26,2022-09-26,Education
40906174,0,474114,-41263499,2022-09-26,2022-09-26,
40906174,0,19725,-41243774,2022-09-26,2022-09-26,
40906174,15429,0,-41259203,2022-09-27,2022-09-27,Entertainment
40906174,0,782014,-40477189,2022-09-27,2022-09-27,
40906174,0,15524,-40461665,2022-09-28,2022-09-28,
40906174,818191,0,-41279856,2022-09-28,2022-09-28,Entertainment
40906174,13730,0,-41293586,2022-09-29,2022-09-29,Transportation
40906174,0,19060,-41274526,2022-09-29,2022-09-29,
40906174,13883,0,-41288409,2022-09-30,2022-09-30,Healthcare
40906174,0,800707,-40487702,2022-10-01,2022-10-01,
40906174,0,14785,-40472917,2022-10-01,2022-10-01,
40906174,961297,0,-41434214,2022-10-01,2022-10-01,Transportation
40906174,994290,0,-42428504,2022-10-02,2022-10-02,Education
40906174,10624,0,-42439128,2022-10-03,2022-10-03,Utilities
40906174,446481,0,-42885609,2022-10-04,2022-10-04,Rent
40906174,0,454034,-42431575,2022-10-04,2022-10-04,
40906174,15256,0,-42446831,2022-10-05,2022-10-05,Groceries
40906174,609811,0,-42040259,2022-10-05,2022-10-05,Education
40906174,0,10150,-42030109,2022-10-06,2022-10-06,
40906174,0,17930,-42012179,2022-10-06,2022-10-06,
40906174,13047,0,-42025226,2022-10-06,2022-10-06,Groceries
40906174,10435,0,-42035661,2022-10-07,2022-10-07,Education
40906174,806564,0,-42842225,2022-10-08,2022-10-08,Transportation
40906174,19775,0,-42862000,2022-10-09,2022-10-09,Utilities
40906174,455311,0,-43317311,2022-10-09,2022-10-09,Education
40906174,0,12005,-43305306,2022-10-10,2022-10-10,
40906174,951595,0,-44256901,2022-10-10,2022-10-10,Clothes
40906174,10972,0,-44267873,2022-10-10,2022-10-10,Education
40906174,12014,0,-44279887,2022-10-11,2022-10-11,Clothes
40906174,13428,0,-44293315,2022-10-11,2022-10-11,Education
40906174,0,887270,-43406045,2022-10-12,2022-10-12,
40906174,0,16007,-43390038,2022-10-12,2022-10-12,
40906174,480777,0,-43870815,2022-10-13,2022-10-13,Utilities
40906174,0,646671,-42903036,2022-10-13,2022-10-13,
40906174,0,526463,-42376573,2022-10-14,2022-10-14,
40906174,876516,0,-43253089,2022-10-14,2022-10-14,Rent
40906174,516094,0,-43769183,2022-10-14,2022-10-14,Rent
40906174,16769,0,-43785952,2022-10-15,2022-10-15,Utilities
40906174,0,17119,-43768833,2022-10-16,2022-10-16,
40906174,0,17852,-43750981,2022-10-17,2022-10-17,
40906174,0,14787,-43736194,2022-10-17,2022-10-17,
40906174,0,709315,-43026879,2022-10-18,2022-10-18,
40906174,10994,0,-43037873,2022-10-18,2022-10-18,Utilities
40906174,649830,0,-43687703,2022-10-18,2022-10-18,Healthcare
40906174,982661,0,-44670364,2022-10-19,2022-10-19,Transportation
40906174,0,15038,-44655326,2022-10-19,2022-10-19,
40906174,18480,0,-44673806,2022-10-20,2022-10-20,Bill Sharing
40906174,0,10307,-44663499,2022-10-20,2022-10-20,
40906174,11261,0,-44674760,2022-10-20,2022-10-20,Clothes
40906174,14437,0,-44689197,2022-10-21,2022-10-21,Clothes
40906174,0,443699,-44245498,2022-10-21,2022-10-21,
40906174,0,412469,-43833029,2022-10-21,2022-10-21,
40906174,0,10833,-43822196,2022-10-22,2022-10-22,
40906174,11944,0,-43834140,2022-10-22,2022-10-22,Entertainment
40906174,0,571750,-43262390,2022-10-23,2022-10-23,
40906174,0,16680,-43245710,2022-10-23,2022-10-23,
40906174,0,755409,-42595692,2022-10-23,2022-10-23,
40906174,0,618279,-41977413,2022-10-24,2022-10-24,
40906174,603529,0,-42580942,2022-10-24,2022-10-24,Education
40906174,967440,0,-43548382,2022-10-24,2022-10-24,Healthcare
40906174,0,828014,-42720368,2022-10-25,2022-10-25,
40906174,15092,0,-42735460,2022-10-25,2022-10-25,Bill Sharing
40906174,17717,0,-42753177,2022-10-26,2022-10-26,Bill Sharing
40906174,0,17533,-42735644,2022-10-26,2022-10-26,
40906174,651595,0,-43387239,2022-10-26,2022-10-26,Transportation
40906174,0,694479,-42692760,2022-10-27,2022-10-27,
40906174,16801,0,-42709561,2022-10-27,2022-10-27,Rent
40906174,0,714112,-41995449,2022-10-28,2022-10-28,
40906174,983700,0,-42979149,2022-10-28,2022-10-28,Bill Sharing
40906174,0,695999,-42283150,2022-10-28,2022-10-28,
40906174,839729,0,-43122879,2022-10-29,2022-10-29,Utilities
40906174,750122,0,-43873001,2022-10-29,2022-10-29,Clothes
40906174,896609,0,-44769610,2022-10-29,2022-10-29,Utilities
40906174,0,16573,-44753037,2022-10-30,2022-10-30,
40906174,0,15778,-44737259,2022-10-30,2022-10-30,
40906174,0,847496,-43889763,2022-10-30,2022-10-30,
40906174,0,853649,-43036114,2022-10-31,2022-10-31,
40906174,744643,0,-43780757,2022-10-31,2022-10-31,Rent
40906174,656075,0,-44436832,2022-11-01,2022-11-01,Healthcare
40906174,904416,0,-43754757,2022-11-01,2022-11-01,Education
40906174,19578,0,-43774335,2022-11-01,2022-11-01,Entertainment
40906174,17193,0,-43791528,2022-11-02,2022-11-02,Utilities
40906174,846502,0,-44638030,2022-11-02,2022-11-02,Transportation
40906174,645987,0,-45284017,2022-11-02,2022-11-02,Healthcare
40906174,0,755741,-44528276,2022-11-03,2022-11-03,
40906174,968856,0,-45497132,2022-11-03,2022-11-03,Clothes
40906174,425403,0,-45922535,2022-11-03,2022-11-03,Utilities
40906174,17977,0,-45940512,2022-11-04,2022-11-04,Groceries
40906174,18960,0,-45959472,2022-11-04,2022-11-04,Entertainment
40906174,0,18926,-45940546,2022-11-04,2022-11-04,
40906174,0,863903,-45076643,2022-11-05,2022-11-05,
40906174,766251,0,-45842894,2022-11-06,2022-11-06,Clothes
40906174,991159,0,-46834053,2022-11-06,2022-11-06,Clothes
40906174,0,702280,-46131773,2022-11-07,2022-11-07,
40906174,683400,0,-46815173,2022-11-07,2022-11-07,Utilities
40906174,0,11845,-46803328,2022-11-08,2022-11-08,
40906174,0,875000,-45928328,2022-11-08,2022-11-08,
40906174,713971,0,-46642299,2022-11-08,2022-11-08,Entertainment
40906174,0,984439,-45657860,2022-11-09,2022-11-09,
40906174,19420,0,-45677280,2022-11-09,2022-11-09,Education
40906174,511215,0,-46188495,2022-11-10,2022-11-10,Bill Sharing
40906174,0,424877,-45763618,2022-11-11,2022-11-11,
40906174,492651,0,-46256269,2022-11-11,2022-11-11,Clothes
40906174,0,505720,-45750549,2022-11-11,2022-11-11,
40906174,0,18596,-45731953,2022-11-12,2022-11-12,
40906174,0,902234,-44829719,2022-11-12,2022-11-12,
40906174,19094,0,-44848813,2022-11-12,2022-11-12,Groceries
40906174,791519,0,-45640332,2022-11-13,2022-11-13,Rent
40906174,706619,0,-46346951,2022-11-14,2022-11-14,Utilities
40906174,10308,0,-46357259,2022-11-15,2022-11-15,Education
40906174,15575,0,-46372834,2022-11-15,2022-11-15,Rent
40906174,19760,0,-46392594,2022-11-15,2022-11-15,Rent
40906174,586266,0,-46978860,2022-11-16,2022-11-16,Healthcare
40906174,0,11881,-46966979,2022-11-17,2022-11-17,
40906174,0,12345,-46954634,2022-11-18,2022-11-18,
40906174,17385,0,-46972019,2022-11-18,2022-11-18,Clothes
40906174,0,19908,-46952111,2022-11-18,2022-11-18,
40906174,16957,0,-46969068,2022-11-19,2022-11-19,Entertainment
40906174,0,407779,-46561289,2022-11-19,2022-11-19,
40906174,737066,0,-47298355,2022-11-20,2022-11-20,Utilities
40906174,12246,0,-47310601,2022-11-21,2022-11-21,Bill Sharing
40906174,10937,0,-47321538,2022-11-21,2022-11-21,Rent
40906174,11387,0,-47332925,2022-11-22,2022-11-22,Bill Sharing
40906174,740865,0,-48073790,2022-11-22,2022-11-22,Clothes
40906174,16889,0,-48090679,2022-11-22,2022-11-22,Rent
40906174,16874,0,-48107553,2022-11-23,2022-11-23,Entertainment
40906174,13266,0,-48120819,2022-11-24,2022-11-24,Utilities
40906174,0,12507,-48108312,2022-11-25,2022-11-25,
40906174,0,512528,-47595784,2022-11-25,2022-11-25,
40906174,0,665008,-46930776,2022-11-25,2022-11-25,
40906174,0,830298,-46918292,2022-11-26,2022-11-26,
40906174,0,641418,-46276874,2022-11-26,2022-11-26,
40906174,0,13263,10000,2022-11-27,2022-11-27,
40906174,0,793284,803284,2022-11-28,2022-11-28,
40906174,15138,0,788146,2022-11-29,2022-11-29,Utilities
40906174,839561,0,10000,2022-11-30,2022-11-30,Groceries
40906174,0,668964,678964,2022-12-01,2022-12-01,
40906174,0,17365,696329,2022-12-01,2022-12-01,
40906174,528994,0,167335,2022-12-02,2022-12-02,Education
40906174,19195,0,148140,2022-12-02,2022-12-02,Clothes
40906174,0,16124,164264,2022-12-02,2022-12-02,
40906174,541334,0,10000,2022-12-03,2022-12-03,Healthcare
40906174,0,10111,20111,2022-12-04,2022-12-04,
40906174,18109,0,10000,2022-12-05,2022-12-05,Transportation
40906174,604413,0,10000,2022-12-05,2022-12-05,Healthcare
40906174,612572,0,10000,2022-12-06,2022-12-06,Utilities
40906174,582923,0,10000,2022-12-06,2022-12-06,Healthcare
40906174,0,474756,484756,2022-12-07,2022-12-07,
40906174,14868,0,469888,2022-12-08,2022-12-08,Healthcare
40906174,563326,0,10000,2022-12-08,2022-12-08,Clothes
40906174,722177,0,10000,2022-12-08,2022-12-08,Transportation
40906174,912900,0,10000,2022-12-09,2022-12-09,Groceries
40906174,964569,0,10000,2022-12-09,2022-12-09,Bill Sharing
40906174,0,548893,558893,2022-12-09,2022-12-09,
40906174,973934,0,10000,2022-12-10,2022-12-10,Education
40906174,0,18392,28392,2022-12-10,2022-12-10,
40906174,0,863549,891941,2022-12-10,2022-12-10,
40906174,0,662779,1554720,2022-12-11,2022-12-11,
40906174,0,15906,1570626,2022-12-11,2022-12-11,
40906174,0,15342,1585968,2022-12-12,2022-12-12,
40906174,0,17797,1603765,2022-12-13,2022-12-13,
40906174,562464,0,1041301,2022-12-13,2022-12-13,Groceries
40906174,444585,0,596716,2022-12-14,2022-12-14,Healthcare
40906174,428766,0,167950,2022-12-14,2022-12-14,Groceries
40906174,968152,0,10000,2022-12-15,2022-12-15,Clothes
40906174,0,579503,589503,2022-12-16,2022-12-16,
40906174,12882,0,576621,2022-12-16,2022-12-16,Healthcare
40906174,446461,0,130160,2022-12-16,2022-12-16,Transportation
40906174,16420,0,113740,2022-12-17,2022-12-17,Rent
40906174,828447,0,10000,2022-12-17,2022-12-17,Utilities
40906174,472479,0,10000,2022-12-17,2022-12-17,Groceries
40906174,711252,0,10000,2022-12-18,2022-12-18,Entertainment
40906174,0,17266,27266,2022-12-18,2022-12-18,
40906174,608284,0,10000,2022-12-18,2022-12-18,Education
40906174,541243,0,10000,2022-12-19,2022-12-19,Transportation
40906174,0,727746,737746,2022-12-20,2022-12-20,
40906174,0,719329,1457075,2022-12-20,2022-12-20,
40906174,0,15707,1472782,2022-12-21,2022-12-21,
40906174,16637,0,1456145,2022-12-21,2022-12-21,Clothes
40906174,11856,0,1444289,2022-12-22,2022-12-22,Education
40906174,0,947364,2391653,2022-12-23,2022-12-23,
40906174,0,15354,2407007,2022-12-23,2022-12-23,
40906174,0,548568,2955575,2022-12-24,2022-12-24,
40906174,12592,0,2942983,2022-12-24,2022-12-24,Utilities
40906174,0,967494,3910477,2022-12-25,2022-12-25,
40906174,0,621648,4532125,2022-12-25,2022-12-25,
40906174,10084,0,4522041,2022-12-26,2022-12-26,Healthcare
40906174,0,913398,5435439,2022-12-27,2022-12-27,
40906174,618473,0,4816966,2022-12-27,2022-12-27,Education
40906174,828141,0,3988825,2022-12-27,2022-12-27,Bill Sharing
40906174,11020,0,3977805,2022-12-28,2022-12-28,Entertainment
40906174,0,13772,3991577,2022-12-28,2022-12-28,
40906174,718184,0,3273393,2022-12-29,2022-12-29,Entertainment
40906174,14941,0,3258452,2022-12-30,2022-12-30,Transportation
40906174,16975,0,3241477,2022-12-30,2022-12-30,Entertainment
40906174,408310,0,2833167,2022-12-30,2022-12-30,Clothes
40906174,664421,0,2168746,2022-12-31,2022-12-31,Groceries
40906174,0,860405,3029151,2022-12-31,2022-12-31,
40906174,777815,0,2251336,2023-01-01,2023-01-01,Clothes
40906174,10488,0,2240848,2023-01-01,2023-01-01,Clothes
40906174,959348,0,1281500,2023-01-02,2023-01-02,Transportation
40906174,0,698419,1927670,2023-01-03,2023-01-03,
40906174,0,16210,1943880,2023-01-03,2023-01-03,
40906174,19435,0,1924445,2023-01-03,2023-01-03,Bill Sharing
40906174,563622,0,1360823,2023-01-04,2023-01-04,Utilities
40906174,0,759486,2120309,2023-01-04,2023-01-04,
40906174,710998,0,1671974,2023-01-05,2023-01-05,Education
40906174,18783,0,1653191,2023-01-05,2023-01-05,Entertainment
40906174,0,850188,2503379,2023-01-06,2023-01-06,
40906174,961565,0,1541814,2023-01-06,2023-01-06,Utilities
40906174,461748,0,1080066,2023-01-06,2023-01-06,Entertainment
40906174,0,480694,1560760,2023-01-07,2023-01-07,
40906174,0,432419,1993179,2023-01-07,2023-01-07,
40906174,11611,0,1981568,2023-01-08,2023-01-08,Education
40906174,0,16068,1997636,2023-01-08,2023-01-08,
40906174,550910,0,1446726,2023-01-08,2023-01-08,Transportation
40906174,925864,0,520862,2023-01-09,2023-01-09,Utilities
40906174,0,408730,1347742,2023-01-09,2023-01-09,
40906174,0,874927,2222669,2023-01-09,2023-01-09,
40906174,16385,0,2206284,2023-01-10,2023-01-10,Healthcare
40906174,535727,0,1670557,2023-01-10,2023-01-10,Bill Sharing
40906174,611316,0,1059241,2023-01-11,2023-01-11,Bill Sharing
40906174,19881,0,1039360,2023-01-11,2023-01-11,Bill Sharing
40906174,0,697824,1737184,2023-01-12,2023-01-12,
40906174,0,715247,1721761,2023-01-12,2023-01-12,
40906174,0,417084,2138845,2023-01-13,2023-01-13,
40906174,715974,0,1422871,2023-01-14,2023-01-14,Transportation
40906174,0,16599,1439470,2023-01-14,2023-01-14,
40906174,0,693150,1427206,2023-01-14,2023-01-14,
40906174,19673,0,1407533,2023-01-15,2023-01-15,Bill Sharing
40906174,0,628493,2036026,2023-01-15,2023-01-15,
40906174,0,596853,2632879,2023-01-16,2023-01-16,
40906174,643412,0,3538465,2023-01-16,2023-01-16,Education
40906174,969386,0,2569079,2023-01-17,2023-01-17,Education
40906174,695409,0,1873670,2023-01-17,2023-01-17,Clothes
40906174,0,10224,1883894,2023-01-17,2023-01-17,
40906174,19669,0,1864225,2023-01-18,2023-01-18,Bill Sharing
40906174,739963,0,1124262,2023-01-18,2023-01-18,Transportation
40906174,14038,0,1110224,2023-01-19,2023-01-19,Bill Sharing
40906174,0,590735,1700959,2023-01-19,2023-01-19,
40906174,0,862953,2563912,2023-01-19,2023-01-19,
40906174,833243,0,1994006,2023-01-20,2023-01-20,Healthcare
40906174,10974,0,1983032,2023-01-20,2023-01-20,Rent
40906174,10936,0,1972096,2023-01-21,2023-01-21,Entertainment
40906174,642381,0,1329715,2023-01-21,2023-01-21,Entertainment
40906174,0,812321,2142036,2023-01-22,2023-01-22,
40906174,629156,0,1512880,2023-01-22,2023-01-22,Utilities
40906174,792672,0,720208,2023-01-22,2023-01-22,Bill Sharing
40906174,711642,0,10000,2023-01-23,2023-01-23,Groceries
40906174,0,17218,27218,2023-01-24,2023-01-24,
40906174,0,15021,42239,2023-01-25,2023-01-25,
40906174,0,12972,55211,2023-01-26,2023-01-26,
40906174,511887,0,10000,2023-01-26,2023-01-26,Clothes
40906174,0,605358,615358,2023-01-27,2023-01-27,
40906174,0,18787,634145,2023-01-28,2023-01-28,
40906174,16817,0,617328,2023-01-28,2023-01-28,Transportation
40906174,19513,0,597815,2023-01-29,2023-01-29,Bill Sharing
40906174,0,17157,614972,2023-01-30,2023-01-30,
40906174,0,17047,632019,2023-01-31,2023-01-31,
40906174,0,694111,1326130,2023-01-31,2023-01-31,
40906174,0,434825,1760955,2023-01-31,2023-01-31,
40906174,0,10079,1771034,2023-02-01,2023-02-01,
40906174,743978,0,1027056,2023-02-02,2023-02-02,Bill Sharing
40906174,0,10810,1037866,2023-02-03,2023-02-03,
40906174,0,874099,1911965,2023-02-03,2023-02-03,
40906174,0,981497,2893462,2023-02-03,2023-02-03,
40906174,0,939670,3833132,2023-02-04,2023-02-04,
40906174,460547,0,3372585,2023-02-04,2023-02-04,Transportation
40906174,905250,0,2467335,2023-02-04,2023-02-04,Rent
40906174,0,446658,2913993,2023-02-05,2023-02-05,
40906174,0,15963,2929956,2023-02-06,2023-02-06,
40906174,0,995827,3384533,2023-02-07,2023-02-07,
40906174,0,18302,3402835,2023-02-07,2023-02-07,
40906174,17235,0,3385600,2023-02-08,2023-02-08,Entertainment
40906174,753529,0,4349535,2023-02-08,2023-02-08,Healthcare
40906174,0,12570,4362105,2023-02-08,2023-02-08,
40906174,10020,0,4352085,2023-02-09,2023-02-09,Healthcare
40906174,18021,0,4334064,2023-02-09,2023-02-09,Utilities
40906174,0,708662,5042726,2023-02-09,2023-02-09,
40906174,811790,0,4230936,2023-02-10,2023-02-10,Transportation
40906174,405117,0,3825819,2023-02-10,2023-02-10,Education
40906174,0,546075,4371894,2023-02-11,2023-02-11,
40906174,653397,0,3718497,2023-02-11,2023-02-11,Groceries
40906174,0,571436,4289933,2023-02-12,2023-02-12,
40906174,979480,0,4308861,2023-02-12,2023-02-12,Healthcare
40906174,0,19024,4327885,2023-02-13,2023-02-13,
40906174,16812,0,4311073,2023-02-13,2023-02-13,Transportation
40906174,16249,0,4294824,2023-02-13,2023-02-13,Transportation
40906174,18831,0,4275993,2023-02-14,2023-02-14,Entertainment
40906174,530251,0,3745742,2023-02-14,2023-02-14,Rent
40906174,0,877563,4623305,2023-02-14,2023-02-14,
40906174,0,13389,4636694,2023-02-15,2023-02-15,
40906174,18965,0,4617729,2023-02-15,2023-02-15,Education
40906174,916454,0,3701275,2023-02-15,2023-02-15,Entertainment
40906174,0,16371,3717646,2023-02-16,2023-02-16,
40906174,944901,0,2772745,2023-02-16,2023-02-16,Education
40906174,783114,0,1989631,2023-02-16,2023-02-16,Bill Sharing
40906174,0,876475,2866106,2023-02-17,2023-02-17,
40906174,520632,0,2345474,2023-02-18,2023-02-18,Entertainment
40906174,612203,0,1733271,2023-02-18,2023-02-18,Bill Sharing
40906174,0,514554,2247825,2023-02-18,2023-02-18,
40906174,0,712271,2960096,2023-02-19,2023-02-19,
40906174,0,950058,3910154,2023-02-19,2023-02-19,
40906174,0,939241,4849395,2023-02-19,2023-02-19,
40906174,0,536863,5386258,2023-02-20,2023-02-20,
40906174,0,739731,5405045,2023-02-20,2023-02-20,
40906174,0,16366,5421411,2023-02-20,2023-02-20,
40906174,525230,0,4896181,2023-02-21,2023-02-21,Clothes
40906174,0,11601,4907782,2023-02-22,2023-02-22,
40906174,0,631404,5539186,2023-02-23,2023-02-23,
40906174,900630,0,4638556,2023-02-24,2023-02-24,Bill Sharing
40906174,654418,0,3984138,2023-02-24,2023-02-24,Education
40906174,0,16657,4000795,2023-02-24,2023-02-24,
40906174,0,18774,4019569,2023-02-25,2023-02-25,
40906174,992865,0,3026704,2023-02-25,2023-02-25,Groceries
40906174,437054,0,2589650,2023-02-25,2023-02-25,Bill Sharing
40906174,909742,0,1679908,2023-02-26,2023-02-26,Groceries
40906174,691229,0,988679,2023-02-26,2023-02-26,Bill Sharing
40906174,10206,0,978473,2023-02-26,2023-02-26,Healthcare
40906174,0,402648,1381121,2023-02-27,2023-02-27,
40906174,16304,0,1364817,2023-02-28,2023-02-28,Utilities
40906174,952912,0,411905,2023-03-01,2023-03-01,Entertainment
40906174,0,481809,893714,2023-03-02,2023-03-02,
40906174,12375,0,881339,2023-03-02,2023-03-02,Healthcare
40906174,0,923335,1804674,2023-03-03,2023-03-03,
40906174,0,685219,2489893,2023-03-04,2023-03-04,
40906174,0,761241,3251134,2023-03-05,2023-03-05,
40906174,474666,0,2776468,2023-03-05,2023-03-05,Groceries
40906174,0,745189,3521657,2023-03-05,2023-03-05,
40906174,988932,0,2532725,2023-03-06,2023-03-06,Rent
40906174,0,742274,3274999,2023-03-06,2023-03-06,
40906174,0,807448,4082447,2023-03-07,2023-03-07,
40906174,0,637512,4719959,2023-03-07,2023-03-07,
40906174,14580,0,4705379,2023-03-07,2023-03-07,Groceries
40906174,15570,0,4689809,2023-03-08,2023-03-08,Clothes
40906174,0,437671,5127480,2023-03-08,2023-03-08,
40906174,0,930706,6058186,2023-03-09,2023-03-09,
40906174,12718,0,6045468,2023-03-09,2023-03-09,Rent
40906174,610281,0,5435187,2023-03-10,2023-03-10,Education
40906174,582057,0,4853130,2023-03-10,2023-03-10,Healthcare
40906174,817694,0,4035436,2023-03-11,2023-03-11,Rent
40906174,0,16353,4051789,2023-03-11,2023-03-11,
40906174,0,647012,4698801,2023-03-11,2023-03-11,
40906174,0,552414,5251215,2023-03-12,2023-03-12,
40906174,0,721885,5973100,2023-03-12,2023-03-12,
40906174,15179,0,5957921,2023-03-12,2023-03-12,Healthcare
40906174,415778,0,5542143,2023-03-13,2023-03-13,Healthcare
40906174,0,896249,6438392,2023-03-13,2023-03-13,
40906174,542946,0,5895446,2023-03-13,2023-03-13,Entertainment
40906174,0,925897,6821343,2023-03-14,2023-03-14,
40906174,408973,0,6412370,2023-03-14,2023-03-14,Groceries
40906174,510115,0,5902255,2023-03-15,2023-03-15,Bill Sharing
40906174,0,582553,6484808,2023-03-16,2023-03-16,
40906174,430158,0,6054650,2023-03-16,2023-03-16,Transportation
40906174,0,14847,6069497,2023-03-17,2023-03-17,
40906174,0,772485,6841982,2023-03-18,2023-03-18,
40906174,0,17457,6859439,2023-03-18,2023-03-18,
40906174,0,11800,6871239,2023-03-19,2023-03-19,
40906174,776794,0,6094445,2023-03-20,2023-03-20,Entertainment
40906174,0,937366,7031811,2023-03-20,2023-03-20,
40906174,452248,0,7050421,2023-03-20,2023-03-20,Education
40906174,479969,0,6570452,2023-03-21,2023-03-21,Clothes
40906174,0,13940,6584392,2023-03-21,2023-03-21,
40906174,13223,0,6571169,2023-03-22,2023-03-22,Bill Sharing
40906174,952989,0,5618180,2023-03-23,2023-03-23,Education
40906174,525157,0,5093023,2023-03-24,2023-03-24,Entertainment
40906174,0,16367,5109390,2023-03-24,2023-03-24,
40906174,637781,0,5123045,2023-03-24,2023-03-24,Healthcare
40906174,0,13859,5136904,2023-03-25,2023-03-25,
40906174,0,684939,5821843,2023-03-25,2023-03-25,
40906174,18265,0,5803578,2023-03-26,2023-03-26,Groceries
40906174,0,905465,6709043,2023-03-26,2023-03-26,
40906174,19465,0,6689578,2023-03-26,2023-03-26,Education
40906174,14303,0,6675275,2023-03-27,2023-03-27,Healthcare
40906174,12036,0,6663239,2023-03-28,2023-03-28,Education
40906174,0,767002,7430241,2023-03-28,2023-03-28,
40906174,0,19120,7449361,2023-03-29,2023-03-29,
40906174,0,911372,8360733,2023-03-30,2023-03-30,
40906174,14065,0,8346668,2023-03-30,2023-03-30,Transportation
40906174,982231,0,7364437,2023-03-31,2023-03-31,Bill Sharing
40906174,0,805895,8170332,2023-03-31,2023-03-31,
40906174,0,795391,8965723,2023-03-31,2023-03-31,
40906174,663175,0,8302548,2023-04-01,2023-04-01,Healthcare
40906174,0,519394,8821942,2023-04-01,2023-04-01,
40906174,12985,0,8808957,2023-04-01,2023-04-01,Bill Sharing
40906174,0,602322,8794038,2023-04-02,2023-04-02,
40906174,17593,0,8776445,2023-04-02,2023-04-02,Groceries
40906174,0,10076,8786521,2023-04-03,2023-04-03,
40906174,12277,0,8774244,2023-04-03,2023-04-03,Entertainment
40906174,676735,0,8097509,2023-04-04,2023-04-04,Clothes
40906174,0,683664,8781173,2023-04-04,2023-04-04,
40906174,0,534826,9315999,2023-04-04,2023-04-04,
40906174,865894,0,8523818,2023-04-05,2023-04-05,Education
40906174,0,13433,8537251,2023-04-05,2023-04-05,
40906174,0,18258,8555509,2023-04-06,2023-04-06,
40906174,0,986835,9542344,2023-04-06,2023-04-06,
40906174,564081,0,8978263,2023-04-06,2023-04-06,Education
40906174,0,910941,9889204,2023-04-07,2023-04-07,
40906174,697519,0,9191685,2023-04-07,2023-04-07,Entertainment
40906174,600690,0,8590995,2023-04-07,2023-04-07,Rent
40906174,941922,0,7649073,2023-04-08,2023-04-08,Groceries
40906174,0,12124,7661197,2023-04-08,2023-04-08,
40906174,0,530250,8191447,2023-04-09,2023-04-09,
40906174,0,15058,8206505,2023-04-09,2023-04-09,
40906174,0,414060,8620565,2023-04-10,2023-04-10,
40906174,16339,0,8604226,2023-04-10,2023-04-10,Transportation
40906174,520797,0,8083429,2023-04-11,2023-04-11,Rent
40906174,0,952847,9036276,2023-04-12,2023-04-12,
40906174,632901,0,8403375,2023-04-12,2023-04-12,Clothes
40906174,519306,0,7884069,2023-04-13,2023-04-13,Education
40906174,467214,0,7416855,2023-04-13,2023-04-13,Entertainment
40906174,11298,0,7405557,2023-04-14,2023-04-14,Education
40906174,0,826953,6688662,2023-04-14,2023-04-14,
40906174,0,18847,6707509,2023-04-15,2023-04-15,
40906174,0,426069,7133578,2023-04-15,2023-04-15,
40906174,968125,0,6165453,2023-04-16,2023-04-16,Rent
40906174,17831,0,6147622,2023-04-17,2023-04-17,Healthcare
40906174,494720,0,5652902,2023-04-18,2023-04-18,Transportation
40906174,658597,0,4994305,2023-04-19,2023-04-19,Rent
40906174,10521,0,4983784,2023-04-19,2023-04-19,Entertainment
40906174,0,18200,5001984,2023-04-20,2023-04-20,
40906174,425839,0,4576145,2023-04-20,2023-04-20,Rent
40906174,504575,0,4071570,2023-04-20,2023-04-20,Healthcare
40906174,0,11441,4083011,2023-04-21,2023-04-21,
40906174,644055,0,3438956,2023-04-21,2023-04-21,Bill Sharing
40906174,0,694140,4133096,2023-04-21,2023-04-21,
40906174,0,569587,4702683,2023-04-22,2023-04-22,
40906174,0,531702,5234385,2023-04-22,2023-04-22,
40906174,929071,0,4305314,2023-04-23,2023-04-23,Rent
40906174,0,772700,5078014,2023-04-24,2023-04-24,
40906174,904079,0,4173935,2023-04-24,2023-04-24,Clothes
40906174,11470,0,4162465,2023-04-25,2023-04-25,Healthcare
40906174,12628,0,4149837,2023-04-26,2023-04-26,Rent
40906174,455344,0,3694493,2023-04-26,2023-04-26,Healthcare
40906174,11885,0,3682608,2023-04-27,2023-04-27,Entertainment
40906174,932878,0,2749730,2023-04-28,2023-04-28,Rent
40906174,0,16176,2765906,2023-04-29,2023-04-29,
40906174,0,650580,3416486,2023-04-29,2023-04-29,
40906174,0,775399,4191885,2023-04-30,2023-04-30,
40906174,0,689691,4881576,2023-04-30,2023-04-30,
40906174,11587,0,4869989,2023-05-01,2023-05-01,Transportation
40906174,785801,0,4084188,2023-05-01,2023-05-01,Healthcare
40906174,19503,0,4064685,2023-05-02,2023-05-02,Transportation
40906174,516044,0,3548641,2023-05-02,2023-05-02,Healthcare
40906174,0,15192,3563833,2023-05-03,2023-05-03,
40906174,782711,0,2781122,2023-05-03,2023-05-03,Groceries
40906174,15394,0,2765728,2023-05-04,2023-05-04,Bill Sharing
40906174,0,906223,3671951,2023-05-05,2023-05-05,
40906174,0,12288,3684239,2023-05-05,2023-05-05,
40906174,997491,0,2686748,2023-05-05,2023-05-05,Rent
40906174,17148,0,2669600,2023-05-06,2023-05-06,Rent
40906174,0,921669,3591269,2023-05-06,2023-05-06,
40906174,801225,0,2790044,2023-05-06,2023-05-06,Bill Sharing
40906174,0,412527,3202571,2023-05-07,2023-05-07,
40906174,0,874055,4076626,2023-05-07,2023-05-07,
40906174,0,476914,4057174,2023-05-08,2023-05-08,
40906174,704593,0,3352581,2023-05-08,2023-05-08,Healthcare
40906174,553060,0,2799521,2023-05-08,2023-05-08,Entertainment
40906174,452017,0,2347504,2023-05-09,2023-05-09,Entertainment
40906174,0,15258,2362762,2023-05-09,2023-05-09,
40906174,0,628124,2990886,2023-05-10,2023-05-10,
40906174,0,774812,3765698,2023-05-10,2023-05-10,
40906174,586988,0,3178710,2023-05-11,2023-05-11,Entertainment
40906174,530721,0,2647989,2023-05-11,2023-05-11,Groceries
40906174,14222,0,2633767,2023-05-11,2023-05-11,Bill Sharing
40906174,0,677738,3311505,2023-05-12,2023-05-12,
40906174,14593,0,3296912,2023-05-12,2023-05-12,Transportation
40906174,0,786786,4083698,2023-05-13,2023-05-13,
40906174,401159,0,3682539,2023-05-14,2023-05-14,Groceries
40906174,0,923950,4606489,2023-05-14,2023-05-14,
40906174,450941,0,4155548,2023-05-14,2023-05-14,Transportation
40906174,0,11610,4167158,2023-05-15,2023-05-15,
40906174,0,11797,4178955,2023-05-15,2023-05-15,
40906174,489437,0,4164980,2023-05-15,2023-05-15,Healthcare
40906174,0,14190,4179170,2023-05-16,2023-05-16,
40906174,543051,0,3636119,2023-05-16,2023-05-16,Entertainment
40906174,0,652296,4288415,2023-05-16,2023-05-16,
40906174,18247,0,4270168,2023-05-17,2023-05-17,Rent
40906174,0,550833,4821001,2023-05-17,2023-05-17,
40906174,0,16659,4837660,2023-05-18,2023-05-18,
40906174,895236,0,3942424,2023-05-18,2023-05-18,Bill Sharing
40906174,0,10449,3952873,2023-05-18,2023-05-18,
40906174,12145,0,3940728,2023-05-19,2023-05-19,Transportation
40906174,0,12026,3952754,2023-05-20,2023-05-20,
40906174,939814,0,3935240,2023-05-20,2023-05-20,Healthcare
40906174,895818,0,3039422,2023-05-21,2023-05-21,Utilities
40906174,0,533187,3572609,2023-05-21,2023-05-21,
40906174,981141,0,2591468,2023-05-21,2023-05-21,Bill Sharing
40906174,0,10107,2601575,2023-05-22,2023-05-22,
40906174,0,13566,2615141,2023-05-22,2023-05-22,
40906174,0,639866,3255007,2023-05-23,2023-05-23,
40906174,838915,0,2416092,2023-05-23,2023-05-23,Education
40906174,0,890285,3306377,2023-05-24,2023-05-24,
40906174,598701,0,2707676,2023-05-24,2023-05-24,Rent
40906174,0,11796,2719472,2023-05-25,2023-05-25,
40906174,10441,0,2709031,2023-05-25,2023-05-25,Clothes
40906174,0,497255,2698105,2023-05-26,2023-05-26,
40906174,12064,0,2686041,2023-05-26,2023-05-26,Healthcare
40906174,541456,0,2144585,2023-05-26,2023-05-26,Groceries
40906174,16235,0,2128350,2023-05-27,2023-05-27,Groceries
40906174,806310,0,1322040,2023-05-27,2023-05-27,Entertainment
40906174,0,416499,1738539,2023-05-28,2023-05-28,
40906174,0,13914,1752453,2023-05-29,2023-05-29,
40906174,0,19325,1771778,2023-05-29,2023-05-29,
40906174,0,721943,2493721,2023-05-30,2023-05-30,
40906174,0,16092,2509813,2023-05-30,2023-05-30,
40906174,859838,0,1649975,2023-05-31,2023-05-31,Healthcare
40906174,0,415013,2064988,2023-05-31,2023-05-31,
40906174,0,19071,2084059,2023-06-01,2023-06-01,
40906174,0,410866,2494925,2023-06-02,2023-06-02,
40906174,0,18801,2513726,2023-06-03,2023-06-03,
40906174,13120,0,2500606,2023-06-04,2023-06-04,Entertainment
40906174,590947,0,1909659,2023-06-05,2023-06-05,Groceries
40906174,0,14068,1923727,2023-06-05,2023-06-05,
40906174,0,688242,2611969,2023-06-06,2023-06-06,
40906174,0,779190,3391159,2023-06-06,2023-06-06,
40906174,608457,0,2782702,2023-06-07,2023-06-07,Bill Sharing
40906174,12499,0,2770203,2023-06-07,2023-06-07,Healthcare
40906174,458381,0,2311822,2023-06-08,2023-06-08,Healthcare
40906174,12610,0,2299212,2023-06-08,2023-06-08,Bill Sharing
40906174,0,14130,2313342,2023-06-08,2023-06-08,
40906174,11075,0,2302267,2023-06-09,2023-06-09,Rent
40906174,520909,0,1781358,2023-06-10,2023-06-10,Entertainment
40906174,0,16644,1798002,2023-06-11,2023-06-11,
40906174,12065,0,1785937,2023-06-11,2023-06-11,Groceries
40906174,11193,0,1774744,2023-06-12,2023-06-12,Entertainment
40906174,0,17474,1792218,2023-06-13,2023-06-13,
40906174,15798,0,1776420,2023-06-14,2023-06-14,Rent
40906174,18267,0,1758153,2023-06-14,2023-06-14,Entertainment
40906174,602644,0,1155509,2023-06-14,2023-06-14,Transportation
40906174,854085,0,301424,2023-06-15,2023-06-15,Transportation
40906174,0,606944,908368,2023-06-15,2023-06-15,
40906174,768921,0,139447,2023-06-15,2023-06-15,Entertainment
40906174,736808,0,10000,2023-06-16,2023-06-16,Rent
40906174,852848,0,10000,2023-06-16,2023-06-16,Entertainment
40906174,0,504935,514935,2023-06-16,2023-06-16,
40906174,0,439789,954724,2023-06-17,2023-06-17,
40906174,0,16716,971440,2023-06-17,2023-06-17,
40906174,14871,0,956569,2023-06-18,2023-06-18,Groceries
40906174,539119,0,417450,2023-06-19,2023-06-19,Rent
40906174,12529,0,404921,2023-06-19,2023-06-19,Groceries
40906174,588692,0,10000,2023-06-20,2023-06-20,Utilities
40906174,773398,0,10000,2023-06-21,2023-06-21,Transportation
40906174,0,18616,28616,2023-06-22,2023-06-22,
40906174,765787,0,10000,2023-06-22,2023-06-22,Bill Sharing
40906174,0,432389,442389,2023-06-22,2023-06-22,
40906174,0,759859,1202248,2023-06-23,2023-06-23,
40906174,565280,0,636968,2023-06-23,2023-06-23,Utilities
40906174,0,18364,655332,2023-06-24,2023-06-24,
40906174,15403,0,639929,2023-06-24,2023-06-24,Utilities
40906174,0,17428,657357,2023-06-24,2023-06-24,
40906174,571362,0,85995,2023-06-25,2023-06-25,Bill Sharing
40906174,461949,0,10000,2023-06-26,2023-06-26,Groceries
40906174,15854,0,10000,2023-06-26,2023-06-26,Groceries
40906174,0,944100,954100,2023-06-27,2023-06-27,
40906174,0,799518,1753618,2023-06-28,2023-06-28,
40906174,0,19061,1772679,2023-06-29,2023-06-29,
40906174,0,861755,2634434,2023-06-29,2023-06-29,
40906174,10857,0,2623577,2023-06-30,2023-06-30,Bill Sharing
40906174,12390,0,2611187,2023-07-01,2023-07-01,Entertainment
40906174,648269,0,1962918,2023-07-02,2023-07-02,Healthcare
40906174,605245,0,1357673,2023-07-02,2023-07-02,Transportation
40906174,875445,0,482228,2023-07-03,2023-07-03,Education
40906174,11143,0,471085,2023-07-04,2023-07-04,Education
40906174,16265,0,454820,2023-07-05,2023-07-05,Entertainment
40906174,0,861670,1316490,2023-07-05,2023-07-05,
40906174,925365,0,391125,2023-07-05,2023-07-05,Transportation
40906174,19295,0,371830,2023-07-06,2023-07-06,Rent
40906174,954537,0,10000,2023-07-07,2023-07-07,Groceries
40906174,0,859992,869992,2023-07-07,2023-07-07,
40906174,13708,0,856284,2023-07-07,2023-07-07,Clothes
40906174,636091,0,870853,2023-07-08,2023-07-08,Education
40906174,0,940861,1811714,2023-07-08,2023-07-08,
40906174,420823,0,1390891,2023-07-08,2023-07-08,Entertainment
40906174,0,448027,1838918,2023-07-09,2023-07-09,
40906174,0,935886,2774804,2023-07-09,2023-07-09,
40906174,12010,0,2762794,2023-07-09,2023-07-09,Bill Sharing
40906174,13032,0,2749762,2023-07-10,2023-07-10,Healthcare
40906174,453082,0,2296680,2023-07-10,2023-07-10,Utilities
40906174,0,517675,2814355,2023-07-11,2023-07-11,
40906174,698519,0,2115836,2023-07-12,2023-07-12,Clothes
40906174,628436,0,1487400,2023-07-12,2023-07-12,Transportation
40906174,0,10749,1498149,2023-07-13,2023-07-13,
40906174,0,11531,1509680,2023-07-14,2023-07-14,
40906174,15269,0,1494411,2023-07-14,2023-07-14,Transportation
40906174,0,908431,2402842,2023-07-14,2023-07-14,
40906174,0,471278,2874120,2023-07-15,2023-07-15,
40906174,15374,0,2858746,2023-07-15,2023-07-15,Transportation
40906174,16767,0,2841979,2023-07-16,2023-07-16,Entertainment
40906174,0,10292,2852271,2023-07-16,2023-07-16,
40906174,484136,0,2368135,2023-07-17,2023-07-17,Utilities
40906174,0,614785,2982920,2023-07-17,2023-07-17,
40906174,0,16395,2999315,2023-07-18,2023-07-18,
40906174,0,701916,3701231,2023-07-19,2023-07-19,
40906174,0,18645,3719876,2023-07-19,2023-07-19,
40906174,0,15934,3735810,2023-07-19,2023-07-19,
40906174,0,762809,4498619,2023-07-20,2023-07-20,
40906174,14387,0,4484232,2023-07-20,2023-07-20,Transportation
40906174,14959,0,4469273,2023-07-21,2023-07-21,Education
40906174,15176,0,4454097,2023-07-21,2023-07-21,Clothes
40906174,10895,0,4443202,2023-07-21,2023-07-21,Groceries
40906174,0,924774,5367976,2023-07-22,2023-07-22,
40906174,0,17587,5385563,2023-07-22,2023-07-22,
40906174,0,880360,6265923,2023-07-22,2023-07-22,
40906174,890741,0,5375182,2023-07-23,2023-07-23,Education
40906174,760207,0,4614975,2023-07-24,2023-07-24,Entertainment
40906174,18222,0,4596753,2023-07-25,2023-07-25,Rent
40906174,0,501405,5556772,2023-07-25,2023-07-25,
40906174,0,933928,5569460,2023-07-25,2023-07-25,
40906174,0,17014,5586474,2023-07-26,2023-07-26,
40906174,0,16979,5603453,2023-07-27,2023-07-27,
40906174,0,10928,5614381,2023-07-28,2023-07-28,
40906174,436282,0,5178099,2023-07-28,2023-07-28,Clothes
40906174,912470,0,4265629,2023-07-28,2023-07-28,Clothes
40906174,14606,0,4251023,2023-07-29,2023-07-29,Groceries
40906174,900481,0,3350542,2023-07-30,2023-07-30,Utilities
40906174,19443,0,3331099,2023-07-30,2023-07-30,Transportation
40906174,15971,0,3315128,2023-07-30,2023-07-30,Groceries
40906174,0,10187,3325315,2023-07-31,2023-07-31,
40906174,0,482151,3807466,2023-07-31,2023-07-31,
40906174,0,710807,4518273,2023-08-01,2023-08-01,
40906174,12529,0,4505744,2023-08-01,2023-08-01,Utilities
40906174,0,986924,5492668,2023-08-02,2023-08-02,
40906174,0,18743,5511411,2023-08-03,2023-08-03,
40906174,837184,0,4674227,2023-08-03,2023-08-03,Utilities
40906174,0,15648,4689875,2023-08-03,2023-08-03,
40906174,476846,0,4213029,2023-08-04,2023-08-04,Groceries
40906174,0,650625,4863654,2023-08-04,2023-08-04,
40906174,668358,0,4195296,2023-08-04,2023-08-04,Healthcare
40906174,16745,0,4178551,2023-08-05,2023-08-05,Transportation
40906174,0,12205,4190756,2023-08-06,2023-08-06,
40906174,789644,0,3401112,2023-08-07,2023-08-07,Groceries
40906174,0,946436,4347548,2023-08-07,2023-08-07,
40906174,0,422341,4769889,2023-08-08,2023-08-08,
40906174,0,17392,4787281,2023-08-08,2023-08-08,
40906174,0,981221,5768502,2023-08-08,2023-08-08,
40906174,0,474028,6242530,2023-08-09,2023-08-09,
40906174,0,12310,6254840,2023-08-09,2023-08-09,
40906174,814831,0,5440009,2023-08-10,2023-08-10,Utilities
40906174,568901,0,4871108,2023-08-11,2023-08-11,Bill Sharing
40906174,732269,0,4138839,2023-08-12,2023-08-12,Rent
40906174,15902,0,4122937,2023-08-13,2023-08-13,Groceries
40906174,13114,0,4109823,2023-08-13,2023-08-13,Entertainment
40906174,10604,0,4099219,2023-08-13,2023-08-13,Utilities
40906174,692855,0,3406364,2023-08-14,2023-08-14,Education
40906174,10686,0,3395678,2023-08-14,2023-08-14,Healthcare
40906174,0,602801,3998479,2023-08-15,2023-08-15,
40906174,847507,0,3150972,2023-08-15,2023-08-15,Groceries
40906174,18429,0,3132543,2023-08-15,2023-08-15,Transportation
40906174,13424,0,3119119,2023-08-16,2023-08-16,Transportation
40906174,0,18078,3137197,2023-08-16,2023-08-16,
40906174,0,868108,4005305,2023-08-16,2023-08-16,
40906174,0,16494,4021799,2023-08-17,2023-08-17,
40906174,0,16807,4038606,2023-08-18,2023-08-18,
40906174,16517,0,4022089,2023-08-19,2023-08-19,Bill Sharing
40906174,10663,0,4011426,2023-08-19,2023-08-19,Utilities
40906174,0,804787,4816213,2023-08-19,2023-08-19,
40906174,472011,0,4344202,2023-08-20,2023-08-20,Rent
40906174,12276,0,4331926,2023-08-20,2023-08-20,Transportation
40906174,632768,0,3699158,2023-08-21,2023-08-21,Utilities
40906174,734251,0,3688725,2023-08-21,2023-08-21,Education
40906174,0,18389,3707114,2023-08-21,2023-08-21,
40906174,733168,0,2973946,2023-08-22,2023-08-22,Entertainment
40906174,424682,0,2549264,2023-08-23,2023-08-23,Clothes
40906174,0,19531,2568795,2023-08-24,2023-08-24,
40906174,0,16566,2585361,2023-08-25,2023-08-25,
40906174,0,17886,2603247,2023-08-25,2023-08-25,
40906174,0,16118,2619365,2023-08-25,2023-08-25,
40906174,0,694660,3314025,2023-08-26,2023-08-26,
40906174,718436,0,2595589,2023-08-27,2023-08-27,Entertainment
40906174,0,481115,3076704,2023-08-28,2023-08-28,
40906174,13915,0,3062789,2023-08-29,2023-08-29,Groceries
40906174,611586,0,2451203,2023-08-29,2023-08-29,Groceries
40906174,0,839622,3290825,2023-08-30,2023-08-30,
40906174,0,14586,3305411,2023-08-30,2023-08-30,
40906174,0,915502,4220913,2023-08-30,2023-08-30,
40906174,436363,0,3784550,2023-08-31,2023-08-31,Clothes
40906174,15479,0,3769071,2023-08-31,2023-08-31,Groceries
40906174,0,726181,4495252,2023-09-01,2023-09-01,
40906174,0,519409,5014661,2023-09-01,2023-09-01,
40906174,0,914694,5929355,2023-09-01,2023-09-01,
40906174,0,12995,5942350,2023-09-02,2023-09-02,
40906174,0,19614,5961964,2023-09-02,2023-09-02,
40906174,0,19347,5981311,2023-09-02,2023-09-02,
40906174,0,626880,6608191,2023-09-03,2023-09-03,
40906174,16807,0,6591384,2023-09-03,2023-09-03,Education
40906174,889497,0,5701887,2023-09-03,2023-09-03,Groceries
40906174,19441,0,5682446,2023-09-04,2023-09-04,Transportation
40906174,0,821083,6503529,2023-09-04,2023-09-04,
40906174,19717,0,6483812,2023-09-04,2023-09-04,Transportation
40906174,0,578145,7061957,2023-09-05,2023-09-05,
40906174,562730,0,6499227,2023-09-05,2023-09-05,Groceries
40906174,0,15663,6514890,2023-09-05,2023-09-05,
40906174,0,13193,6528083,2023-09-06,2023-09-06,
40906174,670658,0,5857425,2023-09-06,2023-09-06,Education
40906174,13053,0,5844372,2023-09-06,2023-09-06,Entertainment
40906174,571022,0,5273350,2023-09-07,2023-09-07,Healthcare
40906174,903910,0,4369440,2023-09-07,2023-09-07,Rent
40906174,14727,0,4354713,2023-09-08,2023-09-08,Clothes
40906174,716544,0,3638169,2023-09-08,2023-09-08,Clothes
40906174,878673,0,2759496,2023-09-08,2023-09-08,Bill Sharing
40906174,0,14319,2773815,2023-09-09,2023-09-09,
40906174,476871,0,2296944,2023-09-09,2023-09-09,Healthcare
40906174,14426,0,2282518,2023-09-09,2023-09-09,Education
40906174,19708,0,2262810,2023-09-10,2023-09-10,Entertainment
40906174,625746,0,1637064,2023-09-11,2023-09-11,Healthcare
40906174,0,418696,2055760,2023-09-11,2023-09-11,
40906174,861226,0,1194534,2023-09-11,2023-09-11,Bill Sharing
40906174,0,949397,2143931,2023-09-12,2023-09-12,
40906174,0,886122,3030053,2023-09-12,2023-09-12,
40906174,12326,0,3017727,2023-09-13,2023-09-13,Groceries
40906174,19107,0,2998620,2023-09-14,2023-09-14,Utilities
40906174,0,761594,3760214,2023-09-14,2023-09-14,
40906174,444278,0,3315936,2023-09-14,2023-09-14,Education
40906174,889386,0,2426550,2023-09-15,2023-09-15,Utilities
40906174,0,616261,3042811,2023-09-15,2023-09-15,
40906174,0,619050,3661861,2023-09-15,2023-09-15,
40906174,0,593639,4255500,2023-09-16,2023-09-16,
40906174,0,16486,4271986,2023-09-17,2023-09-17,
40906174,647501,0,3624485,2023-09-17,2023-09-17,Transportation
40906174,0,473734,4098219,2023-09-18,2023-09-18,
40906174,943831,0,3154388,2023-09-18,2023-09-18,Clothes
40906174,10455,0,3143933,2023-09-18,2023-09-18,Utilities
40906174,0,15121,3159054,2023-09-19,2023-09-19,
40906174,15792,0,3143262,2023-09-19,2023-09-19,Entertainment
40906174,0,777550,3920812,2023-09-19,2023-09-19,
40906174,14165,0,3906647,2023-09-20,2023-09-20,Utilities
40906174,0,605055,4511702,2023-09-20,2023-09-20,
40906174,0,561696,5073398,2023-09-21,2023-09-21,
40906174,677645,0,4395753,2023-09-21,2023-09-21,Rent
40906174,0,694199,5089952,2023-09-22,2023-09-22,
40906174,10427,0,5079525,2023-09-23,2023-09-23,Transportation
40906174,0,451395,5093500,2023-09-24,2023-09-24,
40906174,0,967089,6060589,2023-09-24,2023-09-24,
40906174,0,412925,6473514,2023-09-25,2023-09-25,
40906174,0,976720,7450234,2023-09-26,2023-09-26,
40906174,0,17137,7467371,2023-09-26,2023-09-26,
40906174,0,447783,7915154,2023-09-27,2023-09-27,
40906174,496761,0,7418393,2023-09-27,2023-09-27,Bill Sharing
40906174,715663,0,6702730,2023-09-28,2023-09-28,Entertainment
40906174,0,624147,7326877,2023-09-28,2023-09-28,
40906174,0,14110,7340987,2023-09-28,2023-09-28,
40906174,982892,0,6358095,2023-09-29,2023-09-29,Clothes
40906174,18426,0,6339669,2023-09-29,2023-09-29,Education
40906174,0,14188,6353857,2023-09-29,2023-09-29,
40906174,515935,0,5837922,2023-09-30,2023-09-30,Healthcare
40906174,0,625919,6463841,2023-10-01,2023-10-01,
40906174,484949,0,5978892,2023-10-01,2023-10-01,Utilities
40906174,763681,0,5215211,2023-10-01,2023-10-01,Utilities
40906174,0,13976,5229187,2023-10-02,2023-10-02,
40906174,0,912079,6141266,2023-10-03,2023-10-03,
40906174,0,957193,7098459,2023-10-04,2023-10-04,
40906174,0,15206,7113665,2023-10-04,2023-10-04,
40906174,848071,0,6265594,2023-10-04,2023-10-04,Rent
40906174,865771,0,5399823,2023-10-05,2023-10-05,Utilities
40906174,0,15357,5415180,2023-10-05,2023-10-05,
40906174,707957,0,4707223,2023-10-06,2023-10-06,Entertainment
40906174,562011,0,4695307,2023-10-07,2023-10-07,Education
40906174,722297,0,3973010,2023-10-07,2023-10-07,Clothes
40906174,0,14745,3987755,2023-10-07,2023-10-07,
40906174,0,732747,4720502,2023-10-08,2023-10-08,
40906174,15101,0,4705401,2023-10-08,2023-10-08,Rent
40906174,0,739756,5445157,2023-10-09,2023-10-09,
40906174,992878,0,5908960,2023-10-09,2023-10-09,Education
40906174,487309,0,5421651,2023-10-10,2023-10-10,Healthcare
40906174,0,864536,6286187,2023-10-11,2023-10-11,
40906174,12613,0,6273574,2023-10-11,2023-10-11,Groceries
40906174,0,16371,6289945,2023-10-12,2023-10-12,
40906174,0,18564,6308509,2023-10-12,2023-10-12,
40906174,0,10047,6318556,2023-10-12,2023-10-12,
40906174,17770,0,6300786,2023-10-13,2023-10-13,Education
40906174,422808,0,5877978,2023-10-13,2023-10-13,Entertainment
40906174,796062,0,5081916,2023-10-14,2023-10-14,Groceries
40906174,917917,0,4163999,2023-10-14,2023-10-14,Utilities
40906174,0,949252,5113251,2023-10-14,2023-10-14,
40906174,0,665811,5779062,2023-10-15,2023-10-15,
40906174,0,11858,5790920,2023-10-15,2023-10-15,
40906174,951467,0,4839453,2023-10-16,2023-10-16,Entertainment
40906174,0,19973,4859426,2023-10-17,2023-10-17,
40906174,0,15300,4874726,2023-10-18,2023-10-18,
40906174,0,551764,5426490,2023-10-18,2023-10-18,
40906174,0,766509,6192999,2023-10-18,2023-10-18,
40906174,0,487513,6680512,2023-10-19,2023-10-19,
40906174,0,790918,7471430,2023-10-19,2023-10-19,
40906174,10297,0,7461133,2023-10-20,2023-10-20,Groceries
40906174,17210,0,7443923,2023-10-20,2023-10-20,Bill Sharing
40906174,0,11555,7455478,2023-10-21,2023-10-21,
40906174,576484,0,6878994,2023-10-21,2023-10-21,Entertainment
40906174,0,643475,7522469,2023-10-22,2023-10-22,
40906174,0,842469,7534367,2023-10-23,2023-10-23,
40906174,0,12938,7547305,2023-10-23,2023-10-23,
40906174,557933,0,6989372,2023-10-23,2023-10-23,Rent
40906174,0,10268,6999640,2023-10-24,2023-10-24,
40906174,17535,0,6982105,2023-10-24,2023-10-24,Transportation
40906174,12558,0,6969547,2023-10-24,2023-10-24,Healthcare
40906174,887010,0,6082537,2023-10-25,2023-10-25,Bill Sharing
40906174,974141,0,5108396,2023-10-25,2023-10-25,Healthcare
40906174,0,941325,6049721,2023-10-26,2023-10-26,
40906174,0,626389,6676110,2023-10-26,2023-10-26,
40906174,0,18861,6694971,2023-10-27,2023-10-27,
40906174,0,971040,7666011,2023-10-27,2023-10-27,
40906174,15119,0,7650892,2023-10-28,2023-10-28,Utilities
40906174,636408,0,7014484,2023-10-28,2023-10-28,Entertainment
40906174,12705,0,7001779,2023-10-28,2023-10-28,Utilities
40906174,13085,0,6988694,2023-10-29,2023-10-29,Groceries
40906174,15744,0,6972950,2023-10-29,2023-10-29,Transportation
40906174,0,847360,7820310,2023-10-29,2023-10-29,
40906174,0,462516,8282826,2023-10-30,2023-10-30,
40906174,0,18047,8300873,2023-10-31,2023-10-31,
40906174,18610,0,8282263,2023-10-31,2023-10-31,Education
40906174,0,486258,8768521,2023-10-31,2023-10-31,
40906174,10116,0,8758405,2023-11-01,2023-11-01,Rent
40906174,0,19451,8777856,2023-11-01,2023-11-01,
40906174,0,643376,9421232,2023-11-01,2023-11-01,
40906174,0,888358,10309590,2023-11-02,2023-11-02,
40906174,18100,0,10291490,2023-11-03,2023-11-03,Clothes
40906174,0,12045,10303535,2023-11-03,2023-11-03,
40906174,824010,0,9479525,2023-11-03,2023-11-03,Rent
40906174,805298,0,8674227,2023-11-04,2023-11-04,Utilities
40906174,0,813216,9487443,2023-11-04,2023-11-04,
40906174,680194,0,8807249,2023-11-05,2023-11-05,Utilities
40906174,11438,0,8795811,2023-11-05,2023-11-05,Bill Sharing
40906174,0,841273,9637084,2023-11-05,2023-11-05,
40906174,0,622165,10259249,2023-11-06,2023-11-06,
40906174,400924,0,9858325,2023-11-06,2023-11-06,Groceries
40906174,0,13443,9871768,2023-11-06,2023-11-06,
40906174,0,14001,9885769,2023-11-07,2023-11-07,
40906174,0,16465,9902234,2023-11-07,2023-11-07,
40906174,0,810488,10712722,2023-11-07,2023-11-07,
40906174,0,924435,11637157,2023-11-08,2023-11-08,
40906174,10289,0,11626868,2023-11-09,2023-11-09,Rent
40906174,982927,0,10643941,2023-11-09,2023-11-09,Healthcare
40906174,0,716012,11359953,2023-11-09,2023-11-09,
40906174,0,554851,11914804,2023-11-10,2023-11-10,
40906174,0,843138,12757942,2023-11-10,2023-11-10,
40906174,19982,0,12737960,2023-11-11,2023-11-11,Rent
40906174,0,747716,13485676,2023-11-11,2023-11-11,
40906174,0,750636,14236312,2023-11-11,2023-11-11,
40906174,11194,0,14225118,2023-11-12,2023-11-12,Healthcare
40906174,0,12775,14237893,2023-11-12,2023-11-12,
40906174,0,735166,14973059,2023-11-13,2023-11-13,
40906174,0,715299,15688358,2023-11-14,2023-11-14,
40906174,990900,0,14697458,2023-11-14,2023-11-14,Entertainment
40906174,12734,0,14684724,2023-11-14,2023-11-14,Rent
40906174,694555,0,13990169,2023-11-15,2023-11-15,Education
40906174,0,583848,14574017,2023-11-15,2023-11-15,
40906174,0,759303,15333320,2023-11-16,2023-11-16,
40906174,0,894861,16228181,2023-11-16,2023-11-16,
40906174,967451,0,15260730,2023-11-17,2023-11-17,Healthcare
40906174,19023,0,15241707,2023-11-17,2023-11-17,Transportation
40906174,14841,0,15226866,2023-11-18,2023-11-18,Utilities
40906174,734333,0,14492533,2023-11-18,2023-11-18,Healthcare
40906174,545822,0,13946711,2023-11-18,2023-11-18,Healthcare
40906174,0,942792,14889503,2023-11-19,2023-11-19,
40906174,0,16913,14906416,2023-11-20,2023-11-20,
40906174,0,17349,14923765,2023-11-20,2023-11-20,
40906174,15748,0,14908017,2023-11-20,2023-11-20,Utilities
40906174,989547,0,13918470,2023-11-21,2023-11-21,Utilities
40906174,0,700458,14618928,2023-11-21,2023-11-21,
40906174,0,13132,14632060,2023-11-22,2023-11-22,
40906174,14083,0,14617977,2023-11-22,2023-11-22,Clothes
40906174,0,431974,15049951,2023-11-23,2023-11-23,
40906174,12081,0,15037870,2023-11-24,2023-11-24,Utilities
40906174,789286,0,14248584,2023-11-24,2023-11-24,Entertainment
40906174,887896,0,13360688,2023-11-24,2023-11-24,Entertainment
40906174,0,17449,13378137,2023-11-25,2023-11-25,
40906174,903070,0,12475067,2023-11-26,2023-11-26,Groceries
40906174,0,17595,12492662,2023-11-26,2023-11-26,
40906174,820170,0,11672492,2023-11-26,2023-11-26,Entertainment
40906174,658495,0,11013997,2023-11-27,2023-11-27,Entertainment
40906174,0,895943,11909940,2023-11-27,2023-11-27,
40906174,0,509381,12419321,2023-11-28,2023-11-28,
40906174,0,14701,12434022,2023-11-28,2023-11-28,
40906174,600219,0,11833803,2023-11-29,2023-11-29,Utilities
40906174,0,846512,12680315,2023-11-29,2023-11-29,
40906174,18619,0,12661696,2023-11-30,2023-11-30,Clothes
40906174,0,448458,13110154,2023-11-30,2023-11-30,
40906174,0,901236,14011390,2023-11-30,2023-11-30,
40906174,0,529440,14540830,2023-12-01,2023-12-01,
40906174,895726,0,13645104,2023-12-01,2023-12-01,Healthcare
40906174,11592,0,13633512,2023-12-01,2023-12-01,Transportation
40906174,0,14732,13648244,2023-12-02,2023-12-02,
40906174,717123,0,12931121,2023-12-02,2023-12-02,Transportation
40906174,15317,0,12915804,2023-12-03,2023-12-03,Clothes
40906174,17734,0,12898070,2023-12-03,2023-12-03,Groceries
40906174,0,961447,13859517,2023-12-04,2023-12-04,
40906174,0,510777,14370294,2023-12-04,2023-12-04,
40906174,667009,0,13703285,2023-12-04,2023-12-04,Utilities
40906174,491029,0,13212256,2023-12-05,2023-12-05,Education
40906174,0,943054,14155310,2023-12-05,2023-12-05,
40906174,0,624005,14779315,2023-12-05,2023-12-05,
40906174,0,10766,14790081,2023-12-06,2023-12-06,
40906174,958357,0,13831724,2023-12-07,2023-12-07,Utilities
40906174,0,603364,14435088,2023-12-07,2023-12-07,
40906174,978100,0,13456988,2023-12-08,2023-12-08,Utilities
40906174,407475,0,13049513,2023-12-08,2023-12-08,Entertainment
40906174,14713,0,13034800,2023-12-08,2023-12-08,Healthcare
40906174,562135,0,12472665,2023-12-09,2023-12-09,Entertainment
40906174,13621,0,12459044,2023-12-09,2023-12-09,Education
40906174,15906,0,12443138,2023-12-10,2023-12-10,Entertainment
40906174,0,432500,12453944,2023-12-11,2023-12-11,
40906174,999715,0,11454229,2023-12-12,2023-12-12,Entertainment
40906174,13912,0,11440317,2023-12-12,2023-12-12,Rent
40906174,492471,0,10947846,2023-12-12,2023-12-12,Healthcare
40906174,0,595812,11543658,2023-12-13,2023-12-13,
40906174,868908,0,10674750,2023-12-14,2023-12-14,Rent
40906174,0,697108,11371858,2023-12-15,2023-12-15,
40906174,0,746183,12118041,2023-12-15,2023-12-15,
40906174,662106,0,11455935,2023-12-15,2023-12-15,Healthcare
40906174,0,10296,11466231,2023-12-16,2023-12-16,
40906174,12056,0,11454175,2023-12-16,2023-12-16,Transportation
40906174,0,971844,12426019,2023-12-17,2023-12-17,
40906174,0,874913,13300932,2023-12-17,2023-12-17,
40906174,0,470990,13771922,2023-12-18,2023-12-18,
40906174,0,16307,13788229,2023-12-19,2023-12-19,
40906174,0,13668,13801897,2023-12-19,2023-12-19,
40906174,865629,0,12936268,2023-12-19,2023-12-19,Groceries
40906174,14975,0,12921293,2023-12-20,2023-12-20,Transportation
40906174,0,15339,12936632,2023-12-21,2023-12-21,
40906174,14987,0,12921645,2023-12-22,2023-12-22,Bill Sharing
40906174,0,16457,12938102,2023-12-22,2023-12-22,
40906174,18541,0,12919561,2023-12-22,2023-12-22,Entertainment
40906174,0,13179,12932740,2023-12-23,2023-12-23,
40906174,871779,0,12060961,2023-12-23,2023-12-23,Education
40906174,590108,0,11470853,2023-12-23,2023-12-23,Transportation
40906174,0,717245,12188098,2023-12-24,2023-12-24,
40906174,0,667093,12855191,2023-12-24,2023-12-24,
40906174,998363,0,12052873,2023-12-24,2023-12-24,Healthcare
40906174,0,19086,12071959,2023-12-25,2023-12-25,
40906174,0,789013,12860972,2023-12-25,2023-12-25,
40906174,723732,0,12137240,2023-12-26,2023-12-26,Education
40906174,13678,0,12123562,2023-12-26,2023-12-26,Entertainment
40906174,15178,0,12108384,2023-12-26,2023-12-26,Groceries
40906174,0,758748,12867132,2023-12-27,2023-12-27,
40906174,0,652320,13519452,2023-12-27,2023-12-27,
40906174,0,695154,14214606,2023-12-27,2023-12-27,
40906174,17232,0,14197374,2023-12-28,2023-12-28,Groceries
40906174,0,12763,14210137,2023-12-28,2023-12-28,
40906174,0,822615,15032752,2023-12-28,2023-12-28,
40906174,465011,0,14567741,2023-12-29,2023-12-29,Rent
40906174,0,603772,15171513,2023-12-29,2023-12-29,
40906174,982090,0,14189423,2023-12-30,2023-12-30,Rent
40906174,609017,0,13580406,2023-12-30,2023-12-30,Rent
40906174,0,542780,14123186,2023-12-30,2023-12-30,
40906174,17607,0,14105579,2023-12-31,2023-12-31,Entertainment
40906174,945219,0,13160360,2023-12-31,2023-12-31,Healthcare
40906174,902748,0,12257612,2024-01-01,2024-01-01,Rent
40906174,0,407074,12664686,2024-01-02,2024-01-02,
40906174,0,17119,12681805,2024-01-02,2024-01-02,
40906174,0,662847,12049801,2024-01-03,2024-01-03,
40906174,10779,0,12039022,2024-01-03,2024-01-03,Entertainment
40906174,705904,0,11333118,2024-01-04,2024-01-04,Entertainment
40906174,0,19984,11353102,2024-01-04,2024-01-04,
40906174,0,649213,12002315,2024-01-05,2024-01-05,
40906174,765847,0,11236468,2024-01-06,2024-01-06,Rent
40906174,469063,0,10767405,2024-01-06,2024-01-06,Groceries
40906174,0,547893,11315298,2024-01-06,2024-01-06,
40906174,0,12174,11327472,2024-01-07,2024-01-07,
40906174,19124,0,11308348,2024-01-07,2024-01-07,Education
40906174,0,417799,11726147,2024-01-08,2024-01-08,
40906174,845476,0,10880671,2024-01-08,2024-01-08,Entertainment
40906174,0,10860,10891531,2024-01-08,2024-01-08,
40906174,445632,0,10445899,2024-01-09,2024-01-09,Clothes
40906174,0,16322,10462221,2024-01-10,2024-01-10,
40906174,792966,0,9669255,2024-01-10,2024-01-10,Bill Sharing
40906174,14832,0,9654423,2024-01-11,2024-01-11,Utilities
40906174,690268,0,8964155,2024-01-12,2024-01-12,Entertainment
40906174,0,482470,9446625,2024-01-12,2024-01-12,
40906174,11384,0,9435241,2024-01-13,2024-01-13,Healthcare
40906174,0,19168,9454409,2024-01-13,2024-01-13,
40906174,0,11723,9466132,2024-01-13,2024-01-13,
40906174,977539,0,8488593,2024-01-14,2024-01-14,Utilities
40906174,0,877084,9365677,2024-01-14,2024-01-14,
40906174,815367,0,8550310,2024-01-15,2024-01-15,Entertainment
40906174,12296,0,8538014,2024-01-15,2024-01-15,Groceries
40906174,706243,0,7831771,2024-01-15,2024-01-15,Rent
40906174,866505,0,6965266,2024-01-16,2024-01-16,Clothes
40906174,855879,0,6109387,2024-01-17,2024-01-17,Utilities
40906174,0,601426,6710813,2024-01-17,2024-01-17,
40906174,609480,0,6101333,2024-01-18,2024-01-18,Transportation
40906174,12815,0,6088518,2024-01-18,2024-01-18,Bill Sharing
40906174,0,952115,7040633,2024-01-18,2024-01-18,
40906174,0,535362,7575995,2024-01-19,2024-01-19,
40906174,16781,0,7559214,2024-01-20,2024-01-20,Groceries
40906174,0,921024,8480238,2024-01-20,2024-01-20,
40906174,847019,0,7633219,2024-01-21,2024-01-21,Groceries
40906174,12974,0,7620245,2024-01-21,2024-01-21,Education
40906174,0,555418,8175663,2024-01-21,2024-01-21,
40906174,19854,0,8155809,2024-01-22,2024-01-22,Entertainment
40906174,16088,0,8139721,2024-01-23,2024-01-23,Entertainment
40906174,0,628769,8768490,2024-01-23,2024-01-23,
40906174,615781,0,8152709,2024-01-23,2024-01-23,Entertainment
40906174,0,11980,8164689,2024-01-24,2024-01-24,
40906174,0,786738,8951427,2024-01-25,2024-01-25,
40906174,0,498511,9449938,2024-01-25,2024-01-25,
40906174,0,19765,9469703,2024-01-25,2024-01-25,
40906174,770153,0,8699550,2024-01-26,2024-01-26,Groceries
40906174,14059,0,8685491,2024-01-27,2024-01-27,Rent
40906174,0,15024,8700515,2024-01-28,2024-01-28,
40906174,403663,0,8296852,2024-01-28,2024-01-28,Groceries
40906174,569343,0,7727509,2024-01-28,2024-01-28,Entertainment
40906174,0,17523,7745032,2024-01-29,2024-01-29,
40906174,745086,0,6999946,2024-01-30,2024-01-30,Education
40906174,10577,0,6989369,2024-01-30,2024-01-30,Clothes
40906174,0,419338,7408707,2024-01-31,2024-01-31,
40906174,0,18364,7427071,2024-01-31,2024-01-31,
40906174,0,563359,7990430,2024-02-01,2024-02-01,
40906174,0,12809,8003239,2024-02-02,2024-02-02,
40906174,652415,0,7350824,2024-02-02,2024-02-02,Utilities
40906174,985500,0,6365324,2024-02-03,2024-02-03,Rent
40906174,10493,0,6354831,2024-02-04,2024-02-04,Entertainment
40906174,0,925383,7280214,2024-02-05,2024-02-05,
40906174,13682,0,7266532,2024-02-06,2024-02-06,Clothes
40906174,0,12009,7278541,2024-02-07,2024-02-07,
40906174,14055,0,7264486,2024-02-07,2024-02-07,Education
40906174,926589,0,6337897,2024-02-07,2024-02-07,Education
40906174,581028,0,5756869,2024-02-08,2024-02-08,Transportation
40906174,0,861948,6618817,2024-02-08,2024-02-08,
40906174,0,17121,6635938,2024-02-08,2024-02-08,
40906174,798481,0,5837457,2024-02-09,2024-02-09,Utilities
40906174,12967,0,5824490,2024-02-09,2024-02-09,Clothes
40906174,0,743501,6567991,2024-02-09,2024-02-09,
40906174,0,584784,7152775,2024-02-10,2024-02-10,
40906174,0,18672,7171447,2024-02-10,2024-02-10,
40906174,18011,0,7153436,2024-02-11,2024-02-11,Utilities
40906174,0,913166,8066602,2024-02-11,2024-02-11,
40906174,11273,0,8055329,2024-02-12,2024-02-12,Groceries
40906174,0,578273,8633602,2024-02-13,2024-02-13,
40906174,10560,0,8623042,2024-02-13,2024-02-13,Healthcare
40906174,804062,0,7818980,2024-02-14,2024-02-14,Healthcare
40906174,0,948979,8767959,2024-02-14,2024-02-14,
40906174,409347,0,8358612,2024-02-15,2024-02-15,Bill Sharing
40906174,0,647010,9005622,2024-02-15,2024-02-15,
40906174,0,778100,9783722,2024-02-15,2024-02-15,
40906174,0,420791,10204513,2024-02-16,2024-02-16,
40906174,16439,0,10188074,2024-02-16,2024-02-16,Rent
40906174,0,509952,10698026,2024-02-17,2024-02-17,
40906174,572744,0,10125282,2024-02-17,2024-02-17,Healthcare
40906174,0,752114,10877396,2024-02-17,2024-02-17,
40906174,10964,0,10866432,2024-02-18,2024-02-18,Healthcare
40906174,0,945152,11811584,2024-02-18,2024-02-18,
40906174,706746,0,11104838,2024-02-19,2024-02-19,Education
40906174,0,16697,11121535,2024-02-19,2024-02-19,
40906174,971632,0,10149903,2024-02-20,2024-02-20,Rent
40906174,0,526691,10676594,2024-02-20,2024-02-20,
40906174,0,19308,10695902,2024-02-21,2024-02-21,
40906174,617533,0,10078369,2024-02-21,2024-02-21,Education
40906174,0,539568,10617937,2024-02-21,2024-02-21,
40906174,0,13385,10631322,2024-02-22,2024-02-22,
40906174,575824,0,10055498,2024-02-22,2024-02-22,Transportation
40906174,0,489096,10544594,2024-02-23,2024-02-23,
40906174,11122,0,10533472,2024-02-23,2024-02-23,Utilities
40906174,689756,0,9843716,2024-02-23,2024-02-23,Transportation
40906174,0,747437,10591153,2024-02-24,2024-02-24,
40906174,774944,0,9816209,2024-02-24,2024-02-24,Groceries
40906174,0,404415,10220624,2024-02-25,2024-02-25,
40906174,0,698442,10919066,2024-02-25,2024-02-25,
40906174,0,17346,10936412,2024-02-26,2024-02-26,
40906174,0,620448,11556860,2024-02-26,2024-02-26,
40906174,18730,0,11538130,2024-02-27,2024-02-27,Entertainment
40906174,0,14089,11552219,2024-02-27,2024-02-27,
40906174,767523,0,10784696,2024-02-28,2024-02-28,Transportation
40906174,0,15588,10800284,2024-02-28,2024-02-28,
40906174,0,805806,11606090,2024-02-28,2024-02-28,
40906174,14778,0,11591312,2024-02-29,2024-02-29,Entertainment
40906174,0,688946,12280258,2024-03-01,2024-03-01,
40906174,552888,0,11727370,2024-03-01,2024-03-01,Healthcare
40906174,732087,0,10995283,2024-03-01,2024-03-01,Education
40906174,484216,0,10511067,2024-03-02,2024-03-02,Healthcare
40906174,14604,0,10496463,2024-03-03,2024-03-03,Entertainment
40906174,0,936998,11433461,2024-03-03,2024-03-03,
40906174,0,17442,11450903,2024-03-04,2024-03-04,
40906174,0,17069,11467972,2024-03-04,2024-03-04,
40906174,0,522550,11990522,2024-03-04,2024-03-04,
40906174,862715,0,11127807,2024-03-05,2024-03-05,Groceries
40906174,0,900543,12028350,2024-03-06,2024-03-06,
40906174,0,763992,12792342,2024-03-07,2024-03-07,
40906174,0,12946,12805288,2024-03-07,2024-03-07,
40906174,439866,0,12365422,2024-03-07,2024-03-07,Groceries
40906174,0,17792,12383214,2024-03-08,2024-03-08,
40906174,673586,0,11709628,2024-03-08,2024-03-08,Healthcare
40906174,0,828556,12538184,2024-03-09,2024-03-09,
40906174,0,18611,12556795,2024-03-10,2024-03-10,
40906174,17134,0,12539661,2024-03-10,2024-03-10,Clothes
40906174,992656,0,11547005,2024-03-10,2024-03-10,Utilities
40906174,947038,0,10599967,2024-03-11,2024-03-11,Clothes
40906174,0,19166,10619133,2024-03-11,2024-03-11,
40906174,591109,0,10028024,2024-03-12,2024-03-12,Rent
40906174,0,18020,10046044,2024-03-12,2024-03-12,
40906174,0,13724,10059768,2024-03-13,2024-03-13,
40906174,0,14052,10073820,2024-03-13,2024-03-13,
40906174,774588,0,9299232,2024-03-14,2024-03-14,Clothes
40906174,750493,0,8548739,2024-03-15,2024-03-15,Healthcare
40906174,0,857369,9406108,2024-03-15,2024-03-15,
40906174,975979,0,8430129,2024-03-16,2024-03-16,Utilities
40906174,672788,0,7757341,2024-03-17,2024-03-17,Education
40906174,0,12772,7770113,2024-03-17,2024-03-17,
40906174,0,706356,8476469,2024-03-18,2024-03-18,
40906174,0,449101,8925570,2024-03-18,2024-03-18,
40906174,888113,0,8943699,2024-03-19,2024-03-19,Education
40906174,844117,0,8099582,2024-03-20,2024-03-20,Groceries
40906174,11355,0,8088227,2024-03-20,2024-03-20,Education
40906174,0,813026,8901253,2024-03-20,2024-03-20,
40906174,0,17133,8918386,2024-03-21,2024-03-21,
40906174,954632,0,7963754,2024-03-21,2024-03-21,Entertainment
40906174,0,767766,8731520,2024-03-21,2024-03-21,
40906174,0,879033,9610553,2024-03-22,2024-03-22,
40906174,0,10937,9621490,2024-03-22,2024-03-22,
40906174,685941,0,8935549,2024-03-22,2024-03-22,Groceries
40906174,0,13466,8949015,2024-03-23,2024-03-23,
40906174,884861,0,8064154,2024-03-24,2024-03-24,Utilities
40906174,0,12468,8076622,2024-03-24,2024-03-24,
40906174,0,695028,8771650,2024-03-25,2024-03-25,
40906174,0,569246,9340896,2024-03-25,2024-03-25,
40906174,0,15817,9356713,2024-03-25,2024-03-25,
40906174,19532,0,9337181,2024-03-26,2024-03-26,Clothes
40906174,0,800290,10137471,2024-03-26,2024-03-26,
40906174,10502,0,10126969,2024-03-26,2024-03-26,Education
40906174,0,539864,10666833,2024-03-27,2024-03-27,
40906174,573408,0,10093425,2024-03-28,2024-03-28,Groceries
40906174,0,14237,10107662,2024-03-29,2024-03-29,
40906174,631654,0,9476008,2024-03-30,2024-03-30,Groceries
40906174,0,506697,9982705,2024-03-31,2024-03-31,
40906174,0,16685,9999390,2024-04-01,2024-04-01,
40906174,10607,0,9988783,2024-04-01,2024-04-01,Education
40906174,0,974403,10963186,2024-04-02,2024-04-02,
40906174,10173,0,10953013,2024-04-02,2024-04-02,Utilities
40906174,721304,0,10231709,2024-04-03,2024-04-03,Healthcare
40906174,18643,0,10213066,2024-04-04,2024-04-04,Groceries
40906174,14545,0,10198521,2024-04-04,2024-04-04,Healthcare
40906174,0,10461,10208982,2024-04-04,2024-04-04,
40906174,0,19345,10228327,2024-04-05,2024-04-05,
40906174,14624,0,10213703,2024-04-06,2024-04-06,Groceries
40906174,10224,0,10203479,2024-04-06,2024-04-06,Healthcare
40906174,16078,0,10187401,2024-04-07,2024-04-07,Utilities
40906174,0,855010,11042411,2024-04-07,2024-04-07,
40906174,0,779522,11821933,2024-04-08,2024-04-08,
40906174,14148,0,11807785,2024-04-09,2024-04-09,Rent
40906174,0,688581,12496366,2024-04-09,2024-04-09,
40906174,0,488927,12985293,2024-04-09,2024-04-09,
40906174,0,544764,13530057,2024-04-10,2024-04-10,
40906174,504903,0,13025154,2024-04-10,2024-04-10,Bill Sharing
40906174,0,12386,13037540,2024-04-10,2024-04-10,
40906174,0,988211,14025751,2024-04-11,2024-04-11,
40906174,734625,0,13291126,2024-04-11,2024-04-11,Healthcare
40906174,18454,0,13272672,2024-04-11,2024-04-11,Rent
40906174,14948,0,13257724,2024-04-12,2024-04-12,Transportation
40906174,0,528195,13785919,2024-04-12,2024-04-12,
40906174,614460,0,13171459,2024-04-12,2024-04-12,Entertainment
40906174,18967,0,13152492,2024-04-13,2024-04-13,Entertainment
40906174,566161,0,12586331,2024-04-14,2024-04-14,Utilities
40906174,0,735344,13321675,2024-04-14,2024-04-14,
40906174,758737,0,12562938,2024-04-14,2024-04-14,Bill Sharing
40906174,944836,0,11618102,2024-04-15,2024-04-15,Bill Sharing
40906174,838954,0,11637091,2024-04-15,2024-04-15,Healthcare
40906174,0,834353,12471444,2024-04-16,2024-04-16,
40906174,0,19156,12490600,2024-04-17,2024-04-17,
40906174,776965,0,12502873,2024-04-17,2024-04-17,Education
40906174,0,12665,12515538,2024-04-18,2024-04-18,
40906174,832737,0,11682801,2024-04-18,2024-04-18,Clothes
40906174,821693,0,12129056,2024-04-19,2024-04-19,Healthcare
40906174,0,11766,12140822,2024-04-20,2024-04-20,
40906174,0,666248,12807070,2024-04-20,2024-04-20,
40906174,0,707209,13514279,2024-04-21,2024-04-21,
40906174,550811,0,12963468,2024-04-22,2024-04-22,Clothes
40906174,754330,0,12209138,2024-04-22,2024-04-22,Entertainment
40906174,868763,0,11340375,2024-04-23,2024-04-23,Transportation
40906174,0,10992,11351367,2024-04-23,2024-04-23,
40906174,0,588153,11939520,2024-04-24,2024-04-24,
40906174,0,14768,11954288,2024-04-24,2024-04-24,
40906174,13862,0,11940426,2024-04-24,2024-04-24,Education
40906174,0,801682,12742108,2024-04-25,2024-04-25,
40906174,0,785769,13527877,2024-04-25,2024-04-25,
40906174,993267,0,12534610,2024-04-25,2024-04-25,Transportation
40906174,13201,0,12521409,2024-04-26,2024-04-26,Rent
40906174,0,13177,12534586,2024-04-27,2024-04-27,
40906174,453554,0,12081032,2024-04-27,2024-04-27,Bill Sharing
40906174,0,17333,12098365,2024-04-28,2024-04-28,
40906174,0,550324,12648689,2024-04-29,2024-04-29,
40906174,0,532389,13181078,2024-04-30,2024-04-30,
40906174,0,14827,13195905,2024-05-01,2024-05-01,
40906174,0,16292,13212197,2024-05-02,2024-05-02,
40906174,842836,0,12369361,2024-05-02,2024-05-02,Rent
40906174,0,968652,13338013,2024-05-02,2024-05-02,
40906174,919784,0,12418229,2024-05-03,2024-05-03,Utilities
40906174,760734,0,11657495,2024-05-03,2024-05-03,Groceries
40906174,0,600413,12257908,2024-05-04,2024-05-04,
40906174,0,728981,12986889,2024-05-04,2024-05-04,
40906174,0,625941,13612830,2024-05-05,2024-05-05,
40906174,0,848649,14461479,2024-05-06,2024-05-06,
40906174,0,16621,14478100,2024-05-06,2024-05-06,
40906174,14967,0,14463133,2024-05-07,2024-05-07,Transportation
40906174,0,15630,14478763,2024-05-08,2024-05-08,
40906174,15896,0,14462867,2024-05-08,2024-05-08,Entertainment
40906174,14121,0,14448746,2024-05-08,2024-05-08,Bill Sharing
40906174,863114,0,13585632,2024-05-09,2024-05-09,Healthcare
40906174,0,16719,13602351,2024-05-10,2024-05-10,
40906174,0,10117,13612468,2024-05-10,2024-05-10,
40906174,0,13543,13626011,2024-05-11,2024-05-11,
40906174,0,13513,13639524,2024-05-12,2024-05-12,
40906174,0,11111,13650635,2024-05-12,2024-05-12,
40906174,18108,0,13632527,2024-05-12,2024-05-12,Entertainment
40906174,18611,0,13613916,2024-05-13,2024-05-13,Clothes
40906174,0,856539,14470455,2024-05-13,2024-05-13,
40906174,450475,0,14019980,2024-05-14,2024-05-14,Healthcare
40906174,878150,0,13141830,2024-05-14,2024-05-14,Transportation
40906174,11519,0,13130311,2024-05-14,2024-05-14,Utilities
40906174,484592,0,12645719,2024-05-15,2024-05-15,Healthcare
40906174,0,623671,13269390,2024-05-16,2024-05-16,
40906174,0,15651,13285041,2024-05-16,2024-05-16,
40906174,508262,0,12776779,2024-05-16,2024-05-16,Entertainment
40906174,943927,0,13512500,2024-05-17,2024-05-17,Healthcare
40906174,0,11766,13524266,2024-05-17,2024-05-17,
40906174,12604,0,13511662,2024-05-17,2024-05-17,Utilities
40906174,0,12328,13523990,2024-05-18,2024-05-18,
40906174,0,808118,14332108,2024-05-19,2024-05-19,
40906174,0,662673,14994781,2024-05-19,2024-05-19,
40906174,0,545138,15539919,2024-05-20,2024-05-20,
40906174,0,767171,16307090,2024-05-21,2024-05-21,
40906174,10453,0,16296637,2024-05-22,2024-05-22,Rent
40906174,19488,0,16277149,2024-05-22,2024-05-22,Bill Sharing
40906174,18637,0,16258512,2024-05-22,2024-05-22,Bill Sharing
40906174,0,10150,16268662,2024-05-23,2024-05-23,
40906174,0,502016,16770678,2024-05-24,2024-05-24,
40906174,0,536684,17307362,2024-05-25,2024-05-25,
40906174,0,548569,17855931,2024-05-26,2024-05-26,
40906174,19258,0,17836673,2024-05-27,2024-05-27,Transportation
40906174,0,807952,18644625,2024-05-27,2024-05-27,
40906174,0,752464,19397089,2024-05-27,2024-05-27,
40906174,13815,0,19383274,2024-05-28,2024-05-28,Healthcare
40906174,0,19107,19402381,2024-05-28,2024-05-28,
40906174,0,19738,19422119,2024-05-29,2024-05-29,
40906174,517344,0,18904775,2024-05-30,2024-05-30,Healthcare
40906174,0,924162,19828937,2024-05-30,2024-05-30,
40906174,0,12092,19841029,2024-05-30,2024-05-30,
40906174,0,938538,20779567,2024-05-31,2024-05-31,
40906174,12959,0,20766608,2024-05-31,2024-05-31,Bill Sharing
40906174,0,12944,20779552,2024-05-31,2024-05-31,
40906174,0,917927,21697479,2024-06-01,2024-06-01,
40906174,883573,0,22493637,2024-06-02,2024-06-02,Healthcare
40906174,13974,0,22479663,2024-06-02,2024-06-02,Healthcare
40906174,0,12211,22491874,2024-06-03,2024-06-03,
40906174,0,426255,22918129,2024-06-03,2024-06-03,
40906174,19575,0,22898554,2024-06-03,2024-06-03,Rent
40906174,0,635269,23533823,2024-06-04,2024-06-04,
40906174,810654,0,22723169,2024-06-04,2024-06-04,Utilities
40906174,0,872792,23595961,2024-06-04,2024-06-04,
40906174,0,12483,23608444,2024-06-05,2024-06-05,
40906174,660120,0,22948324,2024-06-05,2024-06-05,Utilities
40906174,0,475673,23423997,2024-06-05,2024-06-05,
40906174,0,921856,24345853,2024-06-06,2024-06-06,
40906174,11801,0,24334052,2024-06-06,2024-06-06,Groceries
40906174,0,795907,25129959,2024-06-07,2024-06-07,
40906174,0,15706,25145665,2024-06-08,2024-06-08,
40906174,0,972963,26118628,2024-06-08,2024-06-08,
40906174,896145,0,25222483,2024-06-08,2024-06-08,Healthcare
40906174,19459,0,25203024,2024-06-09,2024-06-09,Groceries
40906174,701398,0,24501626,2024-06-09,2024-06-09,Entertainment
40906174,712105,0,23789521,2024-06-10,2024-06-10,Rent
40906174,0,13066,23802587,2024-06-11,2024-06-11,
40906174,17950,0,23784637,2024-06-12,2024-06-12,Rent
40906174,0,17549,23802186,2024-06-12,2024-06-12,
40906174,561340,0,23240846,2024-06-13,2024-06-13,Transportation
40906174,561637,0,22679209,2024-06-13,2024-06-13,Bill Sharing
40906174,883381,0,21795828,2024-06-14,2024-06-14,Utilities
40906174,755554,0,21040274,2024-06-14,2024-06-14,Clothes
40906174,0,712457,21752731,2024-06-14,2024-06-14,
40906174,0,19799,21772530,2024-06-15,2024-06-15,
40906174,0,816355,22588885,2024-06-16,2024-06-16,
40906174,0,506910,23095795,2024-06-16,2024-06-16,
40906174,726494,0,22369301,2024-06-17,2024-06-17,Clothes
40906174,0,11509,22380810,2024-06-17,2024-06-17,
40906174,0,16647,22397457,2024-06-18,2024-06-18,
40906174,0,11294,22408751,2024-06-19,2024-06-19,
40906174,456614,0,21952137,2024-06-19,2024-06-19,Transportation
40906174,965239,0,20986898,2024-06-19,2024-06-19,Groceries
40906174,15767,0,20971131,2024-06-20,2024-06-20,Healthcare
40906174,0,669905,20957909,2024-06-21,2024-06-21,
40906174,545204,0,20412705,2024-06-21,2024-06-21,Transportation
40906174,15215,0,20397490,2024-06-21,2024-06-21,Utilities
40906174,0,648360,21045850,2024-06-22,2024-06-22,
40906174,0,609128,21654978,2024-06-22,2024-06-22,
40906174,0,14464,21669442,2024-06-22,2024-06-22,
40906174,902956,0,20766486,2024-06-23,2024-06-23,Rent
40906174,727492,0,20038994,2024-06-23,2024-06-23,Rent
40906174,730014,0,19308980,2024-06-23,2024-06-23,Bill Sharing
40906174,478503,0,18830477,2024-06-24,2024-06-24,Clothes
40906174,540778,0,18289699,2024-06-25,2024-06-25,Transportation
40906174,619238,0,17670461,2024-06-26,2024-06-26,Clothes
40906174,408781,0,17261680,2024-06-26,2024-06-26,Utilities
40906174,0,10143,17271823,2024-06-27,2024-06-27,
40906174,0,16184,17288007,2024-06-27,2024-06-27,
40906174,0,952841,18240848,2024-06-28,2024-06-28,
40906174,0,410458,18651306,2024-06-28,2024-06-28,
40906174,0,638610,19289916,2024-06-29,2024-06-29,
40906174,0,17171,19307087,2024-06-29,2024-06-29,
40906174,0,916326,20223413,2024-06-29,2024-06-29,
40906174,643545,0,19579868,2024-06-30,2024-06-30,Bill Sharing
40906174,15499,0,19564369,2024-06-30,2024-06-30,Healthcare
40906174,552864,0,20053546,2024-07-01,2024-07-01,Healthcare
40906174,19526,0,20034020,2024-07-01,2024-07-01,Education
40906174,430283,0,19603737,2024-07-02,2024-07-02,Clothes
40906174,0,434115,20037852,2024-07-02,2024-07-02,
40906174,0,926470,20964322,2024-07-03,2024-07-03,
40906174,14117,0,20950205,2024-07-04,2024-07-04,Education
40906174,14660,0,20935545,2024-07-04,2024-07-04,Education
40906174,655305,0,20280240,2024-07-05,2024-07-05,Clothes
40906174,849878,0,19430362,2024-07-05,2024-07-05,Rent
40906174,10139,0,19420223,2024-07-05,2024-07-05,Rent
40906174,0,10299,19430522,2024-07-06,2024-07-06,
40906174,0,14573,19445095,2024-07-06,2024-07-06,
40906174,0,634783,20079878,2024-07-07,2024-07-07,
40906174,0,10216,20090094,2024-07-08,2024-07-08,
40906174,969619,0,19120475,2024-07-08,2024-07-08,Clothes
40906174,0,468206,19588681,2024-07-09,2024-07-09,
40906174,0,535448,20124129,2024-07-10,2024-07-10,
40906174,794406,0,19329723,2024-07-10,2024-07-10,Bill Sharing
40906174,10851,0,19318872,2024-07-10,2024-07-10,Healthcare
40906174,18736,0,19300136,2024-07-11,2024-07-11,Rent
40906174,0,875976,20176112,2024-07-12,2024-07-12,
40906174,0,11104,20187216,2024-07-13,2024-07-13,
40906174,0,917068,21104284,2024-07-14,2024-07-14,
40906174,16243,0,21088041,2024-07-15,2024-07-15,Education
40906174,0,436956,21524997,2024-07-15,2024-07-15,
40906174,0,18231,21543228,2024-07-16,2024-07-16,
40906174,452160,0,21091068,2024-07-16,2024-07-16,Utilities
40906174,0,18918,21109986,2024-07-16,2024-07-16,
40906174,0,18075,21128061,2024-07-17,2024-07-17,
40906174,0,746886,21874947,2024-07-17,2024-07-17,
40906174,591969,0,21282978,2024-07-18,2024-07-18,Groceries
40906174,11308,0,21271670,2024-07-18,2024-07-18,Healthcare
40906174,529222,0,20742448,2024-07-18,2024-07-18,Rent
40906174,0,15175,20757623,2024-07-19,2024-07-19,
40906174,15706,0,20741917,2024-07-19,2024-07-19,Bill Sharing
40906174,0,11616,20753533,2024-07-19,2024-07-19,
40906174,13456,0,20740077,2024-07-20,2024-07-20,Clothes
40906174,602895,0,20137182,2024-07-21,2024-07-21,Groceries
40906174,619792,0,19679141,2024-07-21,2024-07-21,Education
40906174,13800,0,19665341,2024-07-21,2024-07-21,Healthcare
40906174,637328,0,19028013,2024-07-22,2024-07-22,Groceries
40906174,537759,0,18490254,2024-07-22,2024-07-22,Healthcare
40906174,0,426366,18916620,2024-07-23,2024-07-23,
40906174,485507,0,18899734,2024-07-24,2024-07-24,Healthcare
40906174,11859,0,18887875,2024-07-24,2024-07-24,Utilities
40906174,464605,0,18423270,2024-07-24,2024-07-24,Utilities
40906174,696595,0,17726675,2024-07-25,2024-07-25,Entertainment
40906174,0,871082,18597757,2024-07-25,2024-07-25,
40906174,17732,0,18580025,2024-07-26,2024-07-26,Healthcare
40906174,0,17325,18597350,2024-07-27,2024-07-27,
40906174,16539,0,18580811,2024-07-28,2024-07-28,Clothes
40906174,815494,0,17765317,2024-07-29,2024-07-29,Education
40906174,938276,0,16827041,2024-07-30,2024-07-30,Utilities
40906174,0,795443,17622484,2024-07-30,2024-07-30,
40906174,620100,0,17603109,2024-07-30,2024-07-30,Education
40906174,13704,0,17589405,2024-07-31,2024-07-31,Healthcare
40906174,0,14322,17603727,2024-07-31,2024-07-31,
40906174,423393,0,17180334,2024-07-31,2024-07-31,Transportation
40906174,0,17543,17197877,2024-08-01,2024-08-01,
40906174,0,571913,17769790,2024-08-02,2024-08-02,
40906174,0,12377,17782167,2024-08-03,2024-08-03,
40906174,777794,0,17004373,2024-08-03,2024-08-03,Rent
40906174,862020,0,16142353,2024-08-03,2024-08-03,Clothes
40906174,16629,0,16125724,2024-08-04,2024-08-04,Groceries
40906174,10453,0,16115271,2024-08-05,2024-08-05,Healthcare
40906174,11182,0,16104089,2024-08-05,2024-08-05,Education
40906174,0,13583,16117672,2024-08-05,2024-08-05,
40906174,19479,0,16098193,2024-08-06,2024-08-06,Groceries
40906174,840079,0,15258114,2024-08-06,2024-08-06,Transportation
40906174,0,885411,16143525,2024-08-07,2024-08-07,
40906174,894924,0,15248601,2024-08-07,2024-08-07,Healthcare
40906174,821421,0,14427180,2024-08-07,2024-08-07,Healthcare
40906174,12878,0,14414302,2024-08-08,2024-08-08,Healthcare
40906174,0,699585,15113887,2024-08-08,2024-08-08,
40906174,11347,0,15102540,2024-08-08,2024-08-08,Groceries
40906174,0,11130,15113670,2024-08-09,2024-08-09,
40906174,0,509993,15623663,2024-08-09,2024-08-09,
40906174,0,14867,15638530,2024-08-10,2024-08-10,
40906174,733545,0,14904985,2024-08-10,2024-08-10,Transportation
40906174,0,19371,14924356,2024-08-10,2024-08-10,
40906174,11004,0,14913352,2024-08-11,2024-08-11,Education
40906174,0,987082,14062954,2024-08-11,2024-08-11,
40906174,840395,0,13222559,2024-08-12,2024-08-12,Education
40906174,951462,0,12271097,2024-08-13,2024-08-13,Utilities
40906174,420977,0,11850120,2024-08-14,2024-08-14,Entertainment
40906174,0,19527,11869647,2024-08-14,2024-08-14,
40906174,17918,0,11851729,2024-08-14,2024-08-14,Transportation
40906174,12074,0,11839655,2024-08-15,2024-08-15,Clothes
40906174,0,14615,11854270,2024-08-16,2024-08-16,
40906174,16445,0,11837825,2024-08-17,2024-08-17,Clothes
40906174,0,834810,12672635,2024-08-17,2024-08-17,
40906174,18632,0,12654003,2024-08-18,2024-08-18,Clothes
40906174,0,595077,13249080,2024-08-18,2024-08-18,
40906174,0,475338,13724418,2024-08-18,2024-08-18,
