Account_No,Withdrawal_amount,Deposit_amount,Balance_amount,Value_date,Data,transaction_details
40906174,18694,0,489,2016-01-01,2016-01-01,Clothes
40906174,0,19578,-20067,2016-01-01,2016-01-01,
40906174,0,14835,-5232,2016-01-02,2016-01-02,
40906174,434740,0,-439972,2016-01-02,2016-01-02,Groceries
40906174,0,17982,-421990,2016-01-02,2016-01-02,
40906174,15144,0,-437134,2016-01-03,2016-01-03,Healthcare
40906174,0,13696,-423438,2016-01-04,2016-01-04,
40906174,451967,0,-875405,2016-01-04,2016-01-04,Transportation
40906174,497379,0,-1372784,2016-01-05,2016-01-05,Rent
40906174,0,407791,-964993,2016-01-05,2016-01-05,
40906174,0,13225,-951768,2016-01-06,2016-01-06,
40906174,0,380019,-571749,2016-01-06,2016-01-06,
40906174,0,445080,-126669,2016-01-06,2016-01-06,
40906174,15066,0,-141735,2016-01-07,2016-01-07,Bill Sharing
40906174,0,470610,328875,2016-01-07,2016-01-07,
40906174,19094,0,309781,2016-01-08,2016-01-08,Transportation
40906174,0,686099,-34197,2016-01-09,2016-01-09,
40906174,378689,0,-412886,2016-01-09,2016-01-09,Utilities
40906174,0,453816,-40930,2016-01-09,2016-01-09,
40906174,396986,0,-437916,2016-01-10,2016-01-10,Rent
40906174,11398,0,-449314,2016-01-10,2016-01-10,Education
40906174,0,479936,-30622,2016-01-11,2016-01-11,
40906174,0,11748,-18874,2016-01-11,2016-01-11,
40906174,0,576550,357793,2016-01-12,2016-01-12,
40906174,391815,0,-34022,2016-01-13,2016-01-13,Clothes
40906174,18184,0,-52206,2016-01-13,2016-01-13,Entertainment
40906174,0,446399,394193,2016-01-14,2016-01-14,
40906174,313455,0,80738,2016-01-14,2016-01-14,Groceries
40906174,0,19294,100032,2016-01-14,2016-01-14,
40906174,0,456017,-556049,2016-01-15,2016-01-15,
40906174,0,18016,-538033,2016-01-15,2016-01-15,
40906174,0,403286,-134747,2016-01-15,2016-01-15,
40906174,0,365151,230404,2016-01-16,2016-01-16,
40906174,311738,0,-81334,2016-01-17,2016-01-17,Utilities
40906174,15583,0,-96917,2016-01-18,2016-01-18,Groceries
40906174,0,15975,-80942,2016-01-19,2016-01-19,
40906174,0,381957,-301015,2016-01-19,2016-01-19,
40906174,17956,0,-318971,2016-01-20,2016-01-20,Healthcare
40906174,14455,0,-333426,2016-01-21,2016-01-21,Education
40906174,0,435891,-102465,2016-01-21,2016-01-21,
40906174,399066,0,-501531,2016-01-21,2016-01-21,Rent
40906174,358406,0,-859937,2016-01-22,2016-01-22,Bill Sharing
40906174,432488,0,-1292425,2016-01-23,2016-01-23,Entertainment
40906174,518378,0,-932234,2016-01-24,2016-01-24,Healthcare
40906174,0,499218,-433016,2016-01-25,2016-01-25,
40906174,0,589747,-10327,2016-01-26,2016-01-26,
40906174,19433,0,-29760,2016-01-26,2016-01-26,Bill Sharing
40906174,400011,0,-429771,2016-01-27,2016-01-27,Groceries
40906174,457464,0,-887235,2016-01-27,2016-01-27,Education
40906174,0,357797,-529438,2016-01-28,2016-01-28,
40906174,363322,0,-892760,2016-01-29,2016-01-29,Bill Sharing
40906174,0,434821,-457939,2016-01-29,2016-01-29,
40906174,496452,0,-954391,2016-01-30,2016-01-30,Education
40906174,463272,0,-1417663,2016-01-30,2016-01-30,Education
40906174,306906,0,-1724569,2016-01-30,2016-01-30,Education
40906174,0,311228,-1413341,2016-01-31,2016-01-31,
40906174,0,441516,-971825,2016-02-01,2016-02-01,
40906174,17587,0,-989412,2016-02-02,2016-02-02,Healthcare
40906174,0,330747,-658665,2016-02-02,2016-02-02,
40906174,0,477109,-181556,2016-02-03,2016-02-03,
40906174,370265,0,-551821,2016-02-03,2016-02-03,Entertainment
40906174,0,488800,-63021,2016-02-04,2016-02-04,
40906174,0,448662,-385641,2016-02-04,2016-02-04,
40906174,0,362721,-22920,2016-02-04,2016-02-04,
40906174,358357,0,-381277,2016-02-05,2016-02-05,Utilities
40906174,0,427588,46311,2016-02-06,2016-02-06,
40906174,0,431794,478105,2016-02-07,2016-02-07,
40906174,13862,0,-464243,2016-02-07,2016-02-07,Rent
40906174,458353,0,-922596,2016-02-08,2016-02-08,Healthcare
40906174,0,476777,-445819,2016-02-09,2016-02-09,
40906174,0,349285,-96534,2016-02-09,2016-02-09,
40906174,0,403999,307465,2016-02-09,2016-02-09,
40906174,0,477744,-785209,2016-02-10,2016-02-10,
40906174,306988,0,-1092197,2016-02-10,2016-02-10,Rent
40906174,0,416159,-676038,2016-02-10,2016-02-10,
40906174,413664,0,-1089702,2016-02-11,2016-02-11,Clothes
40906174,0,414583,-675119,2016-02-11,2016-02-11,
40906174,492702,0,-1167821,2016-02-11,2016-02-11,Clothes
40906174,0,497089,-670732,2016-02-12,2016-02-12,
40906174,0,18262,-652470,2016-02-12,2016-02-12,
40906174,11101,0,-663571,2016-02-13,2016-02-13,Groceries
40906174,323618,0,-987189,2016-02-13,2016-02-13,Healthcare
40906174,497108,0,-1484297,2016-02-13,2016-02-13,Groceries
40906174,495642,0,-1979939,2016-02-14,2016-02-14,Clothes
40906174,13109,0,-1993048,2016-02-14,2016-02-14,Bill Sharing
40906174,18139,0,-2011187,2016-02-14,2016-02-14,Groceries
40906174,370905,0,-2382092,2016-02-15,2016-02-15,Education
40906174,350848,0,-2732940,2016-02-15,2016-02-15,Clothes
40906174,326031,0,-3058971,2016-02-15,2016-02-15,Entertainment
40906174,0,412819,-2646152,2016-02-16,2016-02-16,
40906174,19640,0,-2665792,2016-02-17,2016-02-17,Rent
40906174,355846,0,-3021638,2016-02-18,2016-02-18,Healthcare
40906174,0,17422,-3004216,2016-02-18,2016-02-18,
40906174,474995,0,-3479211,2016-02-18,2016-02-18,Entertainment
40906174,0,17189,-3462022,2016-02-19,2016-02-19,
40906174,376870,0,-3838892,2016-02-20,2016-02-20,Education
40906174,19708,0,-3858600,2016-02-20,2016-02-20,Rent
40906174,447128,0,-4305728,2016-02-21,2016-02-21,Transportation
40906174,11900,0,-4317628,2016-02-22,2016-02-22,Healthcare
40906174,14585,0,-4332213,2016-02-23,2016-02-23,Groceries
40906174,0,13447,-4318766,2016-02-23,2016-02-23,
40906174,0,14625,-4304141,2016-02-24,2016-02-24,
40906174,0,13662,-4290479,2016-02-25,2016-02-25,
40906174,18483,0,-4308962,2016-02-26,2016-02-26,Clothes
40906174,312579,0,-4621541,2016-02-27,2016-02-27,Healthcare
40906174,331252,0,-4952793,2016-02-28,2016-02-28,Education
40906174,0,333104,-4619689,2016-02-28,2016-02-28,
40906174,0,17483,-4602206,2016-02-29,2016-02-29,
40906174,10995,0,-4613201,2016-02-29,2016-02-29,Bill Sharing
40906174,0,13621,-4599580,2016-03-01,2016-03-01,
40906174,19589,0,-4619169,2016-03-01,2016-03-01,Entertainment
40906174,430414,0,-5049583,2016-03-01,2016-03-01,Clothes
40906174,331662,0,-5381245,2016-03-02,2016-03-02,Transportation
40906174,0,12952,-5368293,2016-03-02,2016-03-02,
40906174,16885,0,-5385178,2016-03-02,2016-03-02,Healthcare
40906174,321126,0,-5706304,2016-03-03,2016-03-03,Groceries
40906174,10656,0,-5716960,2016-03-04,2016-03-04,Utilities
40906174,0,13029,-5703931,2016-03-05,2016-03-05,
40906174,777002,0,-5722048,2016-03-05,2016-03-05,Healthcare
40906174,0,14598,-5707450,2016-03-06,2016-03-06,
40906174,19042,0,-5726492,2016-03-07,2016-03-07,Utilities
40906174,434574,0,-6161066,2016-03-07,2016-03-07,Utilities
40906174,0,542267,-5735591,2016-03-07,2016-03-07,
40906174,463610,0,-6199201,2016-03-08,2016-03-08,Entertainment
40906174,325354,0,-6524555,2016-03-08,2016-03-08,Clothes
40906174,378264,0,-6902819,2016-03-09,2016-03-09,Rent
40906174,384837,0,-7287656,2016-03-09,2016-03-09,Healthcare
40906174,13146,0,-7300802,2016-03-09,2016-03-09,Education
40906174,0,16181,-7284621,2016-03-10,2016-03-10,
40906174,0,393821,-6890800,2016-03-10,2016-03-10,
40906174,0,18743,-6872057,2016-03-11,2016-03-11,
40906174,0,16047,-6856010,2016-03-11,2016-03-11,
40906174,359216,0,-7215226,2016-03-12,2016-03-12,Clothes
40906174,443471,0,-7658697,2016-03-12,2016-03-12,Transportation
40906174,0,438766,-7219931,2016-03-12,2016-03-12,
40906174,0,13335,-7206596,2016-03-13,2016-03-13,
40906174,10830,0,-7217426,2016-03-13,2016-03-13,Healthcare
40906174,0,304630,-6912796,2016-03-13,2016-03-13,
40906174,0,13852,-6898944,2016-03-14,2016-03-14,
40906174,0,418627,-6480317,2016-03-15,2016-03-15,
40906174,14443,0,-6494760,2016-03-15,2016-03-15,Healthcare
40906174,0,11285,-6483475,2016-03-16,2016-03-16,
40906174,0,321780,-6161695,2016-03-16,2016-03-16,
40906174,0,13399,-6148296,2016-03-17,2016-03-17,
40906174,0,419748,-5728548,2016-03-17,2016-03-17,
40906174,0,352968,-5375580,2016-03-17,2016-03-17,
40906174,0,13613,-5361967,2016-03-18,2016-03-18,
40906174,16329,0,-5378296,2016-03-19,2016-03-19,Utilities
40906174,0,456456,-4921840,2016-03-20,2016-03-20,
40906174,15307,0,-4937147,2016-03-21,2016-03-21,Transportation
40906174,0,16672,-4920475,2016-03-21,2016-03-21,
40906174,13277,0,-4933752,2016-03-21,2016-03-21,Transportation
40906174,15139,0,-4948891,2016-03-22,2016-03-22,Clothes
40906174,0,420240,-4528651,2016-03-22,2016-03-22,
40906174,17040,0,-4545691,2016-03-22,2016-03-22,Clothes
40906174,0,431439,-4114252,2016-03-23,2016-03-23,
40906174,0,390036,-3724216,2016-03-23,2016-03-23,
40906174,441934,0,-4166150,2016-03-24,2016-03-24,Entertainment
40906174,0,432128,-3734022,2016-03-24,2016-03-24,
40906174,0,19023,-3714999,2016-03-25,2016-03-25,
40906174,0,10184,-3704815,2016-03-25,2016-03-25,
40906174,0,439032,-3265783,2016-03-25,2016-03-25,
40906174,18640,0,-3284423,2016-03-26,2016-03-26,Utilities
40906174,0,325356,-2959067,2016-03-26,2016-03-26,
40906174,0,402559,-2556508,2016-03-26,2016-03-26,
40906174,12815,0,-2569323,2016-03-27,2016-03-27,Utilities
40906174,0,324476,-2244847,2016-03-27,2016-03-27,
40906174,398958,0,-2643805,2016-03-27,2016-03-27,Transportation
40906174,0,12449,-2631356,2016-03-28,2016-03-28,
40906174,18980,0,-2650336,2016-03-28,2016-03-28,Groceries
40906174,407063,0,-3057399,2016-03-28,2016-03-28,Bill Sharing
40906174,0,14058,-3043341,2016-03-29,2016-03-29,
40906174,12797,0,-3056138,2016-03-29,2016-03-29,Bill Sharing
40906174,17341,0,-3073479,2016-03-29,2016-03-29,Utilities
40906174,15299,0,-3088778,2016-03-30,2016-03-30,Healthcare
40906174,408638,0,-3497416,2016-03-31,2016-03-31,Rent
40906174,340138,0,-3837554,2016-03-31,2016-03-31,Entertainment
40906174,0,13397,-3824157,2016-03-31,2016-03-31,
40906174,350206,0,-4174363,2016-04-01,2016-04-01,Transportation
40906174,0,532318,-3834033,2016-04-02,2016-04-02,
40906174,10476,0,-3844509,2016-04-03,2016-04-03,Rent
40906174,12064,0,-3856573,2016-04-03,2016-04-03,Bill Sharing
40906174,471195,0,-4327768,2016-04-04,2016-04-04,Education
40906174,0,440060,-3887708,2016-04-05,2016-04-05,
40906174,17162,0,-3904870,2016-04-05,2016-04-05,Education
40906174,927395,0,-3509399,2016-04-05,2016-04-05,Healthcare
40906174,0,490341,-3019058,2016-04-06,2016-04-06,
40906174,0,397506,-2621552,2016-04-06,2016-04-06,
40906174,496659,0,-3118211,2016-04-06,2016-04-06,Clothes
40906174,14456,0,-3132667,2016-04-07,2016-04-07,Education
40906174,0,18137,-3114530,2016-04-07,2016-04-07,
40906174,11516,0,-3126046,2016-04-08,2016-04-08,Groceries
40906174,380511,0,-3506557,2016-04-09,2016-04-09,Bill Sharing
40906174,393761,0,-3900318,2016-04-10,2016-04-10,Clothes
40906174,17162,0,-3917480,2016-04-10,2016-04-10,Healthcare
40906174,412344,0,-4329824,2016-04-11,2016-04-11,Clothes
40906174,0,413429,-3916395,2016-04-11,2016-04-11,
40906174,477923,0,-4394318,2016-04-12,2016-04-12,Healthcare
40906174,0,18902,-4375416,2016-04-12,2016-04-12,
40906174,14771,0,-4390187,2016-04-13,2016-04-13,Healthcare
40906174,0,490930,-3899257,2016-04-13,2016-04-13,
40906174,304234,0,-4203491,2016-04-13,2016-04-13,Utilities
40906174,0,19085,-4184406,2016-04-14,2016-04-14,
40906174,414379,0,-4598785,2016-04-15,2016-04-15,Utilities
40906174,0,12274,-4586511,2016-04-15,2016-04-15,
40906174,19047,0,-4605558,2016-04-16,2016-04-16,Bill Sharing
40906174,485630,0,-5091188,2016-04-17,2016-04-17,Transportation
40906174,0,15875,-5075313,2016-04-17,2016-04-17,
40906174,308505,0,-5383818,2016-04-18,2016-04-18,Entertainment
40906174,442801,0,-5826619,2016-04-19,2016-04-19,Groceries
40906174,0,547899,-5424358,2016-04-19,2016-04-19,
40906174,462571,0,-5886929,2016-04-19,2016-04-19,Clothes
40906174,0,14027,-5872902,2016-04-20,2016-04-20,
40906174,10897,0,-5883799,2016-04-21,2016-04-21,Healthcare
40906174,0,11279,-5872520,2016-04-21,2016-04-21,
40906174,0,390052,-5482468,2016-04-22,2016-04-22,
40906174,0,18070,-5464398,2016-04-22,2016-04-22,
40906174,0,390949,-5073449,2016-04-23,2016-04-23,
40906174,465149,0,-5538598,2016-04-23,2016-04-23,Bill Sharing
40906174,0,356687,-5181911,2016-04-24,2016-04-24,
40906174,443567,0,-5625478,2016-04-24,2016-04-24,Utilities
40906174,16006,0,-5641484,2016-04-24,2016-04-24,Groceries
40906174,0,17825,-5623659,2016-04-25,2016-04-25,
40906174,333262,0,-5956921,2016-04-26,2016-04-26,Utilities
40906174,0,473653,-5483268,2016-04-27,2016-04-27,
40906174,0,11057,-5472211,2016-04-27,2016-04-27,
40906174,314757,0,-5786968,2016-04-28,2016-04-28,Clothes
40906174,331162,0,-6118130,2016-04-28,2016-04-28,Rent
40906174,493045,0,-6611175,2016-04-28,2016-04-28,Groceries
40906174,0,19782,-6591393,2016-04-29,2016-04-29,
40906174,0,493003,-6098390,2016-04-29,2016-04-29,
40906174,387295,0,-6485685,2016-04-30,2016-04-30,Entertainment
40906174,499509,0,-6985194,2016-05-01,2016-05-01,Groceries
40906174,0,491495,-6493699,2016-05-02,2016-05-02,
40906174,0,395975,-6097724,2016-05-02,2016-05-02,
40906174,0,17534,-6080190,2016-05-02,2016-05-02,
40906174,758411,0,-5707321,2016-05-03,2016-05-03,Education
40906174,0,459417,-5247904,2016-05-03,2016-05-03,
40906174,0,361738,-4886166,2016-05-04,2016-05-04,
40906174,0,13194,-4872972,2016-05-04,2016-05-04,
40906174,468847,0,-5341819,2016-05-05,2016-05-05,Education
40906174,19368,0,-5361187,2016-05-05,2016-05-05,Clothes
40906174,375220,0,-5736407,2016-05-05,2016-05-05,Utilities
40906174,0,457655,-5278752,2016-05-06,2016-05-06,
40906174,0,346824,-4931928,2016-05-06,2016-05-06,
40906174,433837,0,-5365765,2016-05-07,2016-05-07,Groceries
40906174,402539,0,-5768304,2016-05-07,2016-05-07,Utilities
40906174,15731,0,-5784035,2016-05-08,2016-05-08,Bill Sharing
40906174,18437,0,-5802472,2016-05-08,2016-05-08,Groceries
40906174,0,453118,-5349354,2016-05-09,2016-05-09,
40906174,0,378970,-4970384,2016-05-10,2016-05-10,
40906174,0,10465,-4959919,2016-05-11,2016-05-11,
40906174,436352,0,-5448146,2016-05-11,2016-05-11,Education
40906174,420175,0,-5868321,2016-05-11,2016-05-11,Groceries
40906174,0,16848,-5851473,2016-05-12,2016-05-12,
40906174,0,420911,-5430562,2016-05-12,2016-05-12,
40906174,0,357178,-5073384,2016-05-12,2016-05-12,
40906174,19062,0,-5092446,2016-05-13,2016-05-13,Entertainment
40906174,0,17857,-5074589,2016-05-14,2016-05-14,
40906174,0,347384,-4727205,2016-05-15,2016-05-15,
40906174,0,10078,-4717127,2016-05-15,2016-05-15,
40906174,0,13131,-4703996,2016-05-16,2016-05-16,
40906174,0,486717,-4217279,2016-05-16,2016-05-16,
40906174,19050,0,-4236329,2016-05-17,2016-05-17,Groceries
40906174,906586,0,-4255852,2016-05-18,2016-05-18,Healthcare
40906174,359978,0,-4615830,2016-05-18,2016-05-18,Bill Sharing
40906174,0,12682,-4603148,2016-05-19,2016-05-19,
40906174,0,491506,-4111642,2016-05-19,2016-05-19,
40906174,0,11616,-4100026,2016-05-19,2016-05-19,
40906174,0,10280,-4089746,2016-05-20,2016-05-20,
40906174,0,356085,-3733661,2016-05-20,2016-05-20,
40906174,17841,0,-3751502,2016-05-20,2016-05-20,Utilities
40906174,0,356208,-3395294,2016-05-21,2016-05-21,
40906174,0,481849,-2913445,2016-05-22,2016-05-22,
40906174,12149,0,-2925594,2016-05-23,2016-05-23,Healthcare
40906174,0,437081,-2488513,2016-05-23,2016-05-23,
40906174,0,11518,-2476995,2016-05-24,2016-05-24,
40906174,0,346695,-2130300,2016-05-25,2016-05-25,
40906174,404335,0,-2534635,2016-05-26,2016-05-26,Education
40906174,0,440215,-2094420,2016-05-26,2016-05-26,
40906174,0,18316,-2076104,2016-05-26,2016-05-26,
40906174,10774,0,-2086878,2016-05-27,2016-05-27,Rent
40906174,361530,0,-2448408,2016-05-28,2016-05-28,Clothes
40906174,0,491706,-1956702,2016-05-28,2016-05-28,
40906174,0,368435,-1588267,2016-05-29,2016-05-29,
40906174,393533,0,-1981800,2016-05-29,2016-05-29,Healthcare
40906174,0,418403,-1563397,2016-05-29,2016-05-29,
40906174,0,14678,-1548719,2016-05-30,2016-05-30,
40906174,0,447948,-1100771,2016-05-31,2016-05-31,
40906174,14477,0,-1115248,2016-06-01,2016-06-01,Utilities
40906174,492760,0,-710678,2016-06-02,2016-06-02,Healthcare
40906174,0,538098,-1192887,2016-06-02,2016-06-02,
40906174,0,17713,-1175174,2016-06-02,2016-06-02,
40906174,17309,0,-1192483,2016-06-03,2016-06-03,Entertainment
40906174,0,11252,-1181231,2016-06-03,2016-06-03,
40906174,0,454706,-726525,2016-06-04,2016-06-04,
40906174,0,18484,-708041,2016-06-04,2016-06-04,
40906174,0,491032,-217009,2016-06-04,2016-06-04,
40906174,497232,0,-714241,2016-06-05,2016-06-05,Healthcare
40906174,436303,0,-1150544,2016-06-06,2016-06-06,Education
40906174,0,701078,-1136413,2016-06-06,2016-06-06,
40906174,0,414076,-722337,2016-06-06,2016-06-06,
40906174,0,15857,-706480,2016-06-07,2016-06-07,
40906174,0,376275,-330205,2016-06-07,2016-06-07,
40906174,0,314914,-15291,2016-06-08,2016-06-08,
40906174,0,424082,408791,2016-06-08,2016-06-08,
40906174,0,436965,-845756,2016-06-09,2016-06-09,
40906174,306148,0,-1151904,2016-06-10,2016-06-10,Clothes
40906174,0,777965,-1135945,2016-06-11,2016-06-11,
40906174,0,18010,-1117935,2016-06-12,2016-06-12,
40906174,394441,0,-1512376,2016-06-12,2016-06-12,Groceries
40906174,324683,0,-1837059,2016-06-12,2016-06-12,Transportation
40906174,482627,0,-2319686,2016-06-13,2016-06-13,Rent
40906174,333323,0,-2653009,2016-06-13,2016-06-13,Healthcare
40906174,0,14753,-2638256,2016-06-14,2016-06-14,
40906174,0,337754,-2300502,2016-06-14,2016-06-14,
40906174,0,495273,-1805229,2016-06-15,2016-06-15,
40906174,0,12271,-1792958,2016-06-16,2016-06-16,
40906174,0,10520,-1782438,2016-06-16,2016-06-16,
40906174,0,17207,-1765231,2016-06-16,2016-06-16,
40906174,0,317645,-1447586,2016-06-17,2016-06-17,
40906174,361082,0,-1808668,2016-06-18,2016-06-18,Transportation
40906174,0,426193,-1382475,2016-06-18,2016-06-18,
40906174,397140,0,-1779615,2016-06-18,2016-06-18,Healthcare
40906174,0,10823,-1768792,2016-06-19,2016-06-19,
40906174,12473,0,-1781265,2016-06-20,2016-06-20,Healthcare
40906174,0,348028,-1433237,2016-06-21,2016-06-21,
40906174,407311,0,-1840548,2016-06-21,2016-06-21,Education
40906174,10844,0,-1851392,2016-06-21,2016-06-21,Bill Sharing
40906174,0,17324,-1834068,2016-06-22,2016-06-22,
40906174,491087,0,-2325155,2016-06-22,2016-06-22,Education
40906174,444921,0,-2770076,2016-06-22,2016-06-22,Entertainment
40906174,0,364311,-2405765,2016-06-23,2016-06-23,
40906174,0,15973,-2389792,2016-06-23,2016-06-23,
40906174,18187,0,-2407979,2016-06-23,2016-06-23,Rent
40906174,0,323960,-2084019,2016-06-24,2016-06-24,
40906174,449411,0,-2533430,2016-06-24,2016-06-24,Transportation
40906174,385667,0,-2919097,2016-06-24,2016-06-24,Bill Sharing
40906174,13254,0,-2932351,2016-06-25,2016-06-25,Rent
40906174,14749,0,-2947100,2016-06-25,2016-06-25,Education
40906174,374436,0,-3321536,2016-06-26,2016-06-26,Clothes
40906174,18547,0,-3340083,2016-06-26,2016-06-26,Healthcare
40906174,0,14933,-3325150,2016-06-27,2016-06-27,
40906174,0,383241,-2941909,2016-06-28,2016-06-28,
40906174,476571,0,-3418480,2016-06-28,2016-06-28,Groceries
40906174,361744,0,-3780224,2016-06-29,2016-06-29,Transportation
40906174,329988,0,-4110212,2016-06-29,2016-06-29,Groceries
40906174,14469,0,-4124681,2016-06-30,2016-06-30,Clothes
40906174,15707,0,-4140388,2016-07-01,2016-07-01,Rent
40906174,482661,0,-4623049,2016-07-01,2016-07-01,Transportation
40906174,305945,0,-4928994,2016-07-02,2016-07-02,Education
40906174,0,425623,-4503371,2016-07-03,2016-07-03,
40906174,0,363331,-4140040,2016-07-04,2016-07-04,
40906174,18802,0,-4158842,2016-07-05,2016-07-05,Entertainment
40906174,0,460237,-3698605,2016-07-05,2016-07-05,
40906174,383850,0,-4082455,2016-07-06,2016-07-06,Utilities
40906174,465276,0,-4547731,2016-07-06,2016-07-06,Transportation
40906174,344851,0,-4892582,2016-07-06,2016-07-06,Entertainment
40906174,0,435429,-4457153,2016-07-07,2016-07-07,
40906174,18093,0,-4475246,2016-07-08,2016-07-08,Transportation
40906174,0,19482,-4455764,2016-07-08,2016-07-08,
40906174,0,334091,-4121673,2016-07-08,2016-07-08,
40906174,0,330722,-3790951,2016-07-09,2016-07-09,
40906174,0,17065,-3773886,2016-07-09,2016-07-09,
40906174,0,499404,-3274482,2016-07-10,2016-07-10,
40906174,0,12367,-3262115,2016-07-10,2016-07-10,
40906174,0,328150,-2933965,2016-07-10,2016-07-10,
40906174,18524,0,-2952489,2016-07-11,2016-07-11,Rent
40906174,573519,0,-2967558,2016-07-11,2016-07-11,Education
40906174,302778,0,-3270336,2016-07-11,2016-07-11,Clothes
40906174,411098,0,-3716905,2016-07-12,2016-07-12,Healthcare
40906174,13819,0,-3730724,2016-07-12,2016-07-12,Rent
40906174,313857,0,-4044581,2016-07-12,2016-07-12,Healthcare
40906174,0,380570,-3664011,2016-07-13,2016-07-13,
40906174,0,493194,-3170817,2016-07-13,2016-07-13,
40906174,341819,0,-3512636,2016-07-13,2016-07-13,Clothes
40906174,0,13407,-3499229,2016-07-14,2016-07-14,
40906174,316256,0,-3815485,2016-07-14,2016-07-14,Healthcare
40906174,0,300636,-3514849,2016-07-15,2016-07-15,
40906174,417420,0,-3932269,2016-07-15,2016-07-15,Groceries
40906174,0,430638,-3501631,2016-07-16,2016-07-16,
40906174,0,17879,-3483752,2016-07-16,2016-07-16,
40906174,0,353613,-3130139,2016-07-16,2016-07-16,
40906174,0,15752,-3114387,2016-07-17,2016-07-17,
40906174,0,436339,-3099268,2016-07-18,2016-07-18,
40906174,17516,0,-3116784,2016-07-18,2016-07-18,Entertainment
40906174,0,634856,-3467565,2016-07-19,2016-07-19,
40906174,0,387139,-3080426,2016-07-19,2016-07-19,
40906174,405025,0,-3485451,2016-07-20,2016-07-20,Groceries
40906174,0,411187,-3074264,2016-07-21,2016-07-21,
40906174,450632,0,-3524896,2016-07-21,2016-07-21,Education
40906174,0,311380,-3213516,2016-07-21,2016-07-21,
40906174,359866,0,-3573382,2016-07-22,2016-07-22,Utilities
40906174,0,422034,-3151348,2016-07-22,2016-07-22,
40906174,327918,0,-3479266,2016-07-23,2016-07-23,Bill Sharing
40906174,0,342209,-3137057,2016-07-23,2016-07-23,
40906174,447201,0,-3584258,2016-07-24,2016-07-24,Transportation
40906174,389677,0,-3973935,2016-07-25,2016-07-25,Healthcare
40906174,0,461651,-3512284,2016-07-25,2016-07-25,
40906174,10376,0,-3522660,2016-07-26,2016-07-26,Transportation
40906174,326014,0,-3848674,2016-07-26,2016-07-26,Education
40906174,19687,0,-3868361,2016-07-26,2016-07-26,Entertainment
40906174,0,372101,-3496260,2016-07-27,2016-07-27,
40906174,0,12372,-3483888,2016-07-28,2016-07-28,
40906174,448944,0,-3932832,2016-07-29,2016-07-29,Transportation
40906174,0,16028,-3916804,2016-07-29,2016-07-29,
40906174,12207,0,-3929011,2016-07-29,2016-07-29,Rent
40906174,13326,0,-3942337,2016-07-30,2016-07-30,Education
40906174,388491,0,-4330828,2016-07-30,2016-07-30,Transportation
40906174,0,493307,-3837521,2016-07-31,2016-07-31,
40906174,471182,0,-4308703,2016-08-01,2016-08-01,Groceries
40906174,413615,0,-4722318,2016-08-01,2016-08-01,Entertainment
40906174,0,17501,-4704817,2016-08-01,2016-08-01,
40906174,0,10337,-4694480,2016-08-02,2016-08-02,
40906174,13010,0,-4707490,2016-08-02,2016-08-02,Utilities
40906174,0,394770,-4312720,2016-08-03,2016-08-03,
40906174,0,480603,-3832117,2016-08-03,2016-08-03,
40906174,0,18307,-3813810,2016-08-04,2016-08-04,
40906174,363233,0,-4177043,2016-08-04,2016-08-04,Education
40906174,18617,0,-4195660,2016-08-04,2016-08-04,Clothes
40906174,0,377128,-3818532,2016-08-05,2016-08-05,
40906174,396131,0,-4214663,2016-08-06,2016-08-06,Healthcare
40906174,456000,0,-4670663,2016-08-06,2016-08-06,Transportation
40906174,13344,0,-4684007,2016-08-07,2016-08-07,Healthcare
40906174,0,390836,-4293171,2016-08-08,2016-08-08,
40906174,855564,0,-3949002,2016-08-09,2016-08-09,Healthcare
40906174,0,12680,-3936322,2016-08-10,2016-08-10,
40906174,0,432251,-3504071,2016-08-10,2016-08-10,
40906174,479509,0,-3983580,2016-08-11,2016-08-11,Bill Sharing
40906174,463447,0,-4447027,2016-08-12,2016-08-12,Groceries
40906174,0,399742,-4047285,2016-08-12,2016-08-12,
40906174,0,374189,-3673096,2016-08-12,2016-08-12,
40906174,0,18802,-3654294,2016-08-13,2016-08-13,
40906174,0,329703,-3324591,2016-08-14,2016-08-14,
40906174,19842,0,-3344433,2016-08-14,2016-08-14,Healthcare
40906174,318447,0,-3662880,2016-08-15,2016-08-15,Utilities
40906174,17847,0,-3680727,2016-08-15,2016-08-15,Transportation
40906174,14048,0,-3694775,2016-08-15,2016-08-15,Bill Sharing
40906174,0,13698,-3681077,2016-08-16,2016-08-16,
40906174,14694,0,-3695771,2016-08-16,2016-08-16,Utilities
40906174,0,390307,-3305464,2016-08-17,2016-08-17,
40906174,14955,0,-3320419,2016-08-18,2016-08-18,Education
40906174,0,466504,-2853915,2016-08-18,2016-08-18,
40906174,0,14115,-2839800,2016-08-19,2016-08-19,
40906174,19938,0,-2859738,2016-08-19,2016-08-19,Healthcare
40906174,367955,0,-3227693,2016-08-19,2016-08-19,Bill Sharing
40906174,0,15054,-3212639,2016-08-20,2016-08-20,
40906174,0,329872,-2882767,2016-08-20,2016-08-20,
40906174,0,427366,-2900380,2016-08-21,2016-08-21,
40906174,0,456862,-2443518,2016-08-22,2016-08-22,
40906174,371462,0,-2814980,2016-08-22,2016-08-22,Entertainment
40906174,15939,0,-2830919,2016-08-22,2016-08-22,Clothes
40906174,19207,0,-2850126,2016-08-23,2016-08-23,Entertainment
40906174,0,355266,-2494860,2016-08-23,2016-08-23,
40906174,0,16464,-2478396,2016-08-24,2016-08-24,
40906174,0,370834,-2107562,2016-08-24,2016-08-24,
40906174,0,493815,-1613747,2016-08-24,2016-08-24,
40906174,391697,0,-2005444,2016-08-25,2016-08-25,Bill Sharing
40906174,464383,0,-2469827,2016-08-25,2016-08-25,Healthcare
40906174,16018,0,-2485845,2016-08-25,2016-08-25,Healthcare
40906174,18931,0,-2504776,2016-08-26,2016-08-26,Transportation
40906174,0,17909,-2486867,2016-08-27,2016-08-27,
40906174,14110,0,-2500977,2016-08-27,2016-08-27,Rent
40906174,0,347890,-2153087,2016-08-28,2016-08-28,
40906174,0,16305,-2136782,2016-08-28,2016-08-28,
40906174,0,481387,-1655395,2016-08-28,2016-08-28,
40906174,0,13618,-1641777,2016-08-29,2016-08-29,
40906174,15074,0,-1656851,2016-08-29,2016-08-29,Healthcare
40906174,0,423304,-1233547,2016-08-30,2016-08-30,
40906174,0,360040,-873507,2016-08-30,2016-08-30,
40906174,0,17593,-855914,2016-08-31,2016-08-31,
40906174,0,427282,-428632,2016-08-31,2016-08-31,
40906174,0,14215,-414417,2016-09-01,2016-09-01,
40906174,17429,0,-431846,2016-09-01,2016-09-01,Education
40906174,0,477166,-45320,2016-09-02,2016-09-02,
40906174,300462,0,-345782,2016-09-02,2016-09-02,Bill Sharing
40906174,307298,0,-653080,2016-09-02,2016-09-02,Education
40906174,10490,0,-663570,2016-09-03,2016-09-03,Rent
40906174,0,338200,-325370,2016-09-03,2016-09-03,
40906174,0,484968,159598,2016-09-03,2016-09-03,
40906174,17480,0,-142118,2016-09-04,2016-09-04,Transportation
40906174,19007,0,-161125,2016-09-05,2016-09-05,Groceries
40906174,12663,0,-173788,2016-09-05,2016-09-05,Entertainment
40906174,0,15226,-158562,2016-09-06,2016-09-06,
40906174,0,468856,-310294,2016-09-06,2016-09-06,
40906174,0,19746,-290548,2016-09-06,2016-09-06,
40906174,0,17292,-273256,2016-09-07,2016-09-07,
40906174,485918,0,-759174,2016-09-07,2016-09-07,Transportation
40906174,0,306418,-452756,2016-09-08,2016-09-08,
40906174,0,453657,901,2016-09-08,2016-09-08,
40906174,304242,0,-303341,2016-09-08,2016-09-08,Rent
40906174,14049,0,-317390,2016-09-09,2016-09-09,Clothes
40906174,450895,0,-768285,2016-09-09,2016-09-09,Utilities
40906174,14614,0,-782899,2016-09-10,2016-09-10,Groceries
40906174,381876,0,-1164775,2016-09-11,2016-09-11,Groceries
40906174,451706,0,-1616481,2016-09-11,2016-09-11,Utilities
40906174,19654,0,-1636135,2016-09-11,2016-09-11,Bill Sharing
40906174,0,487978,-1148157,2016-09-12,2016-09-12,
40906174,0,363139,-785018,2016-09-13,2016-09-13,
40906174,0,458600,-326418,2016-09-13,2016-09-13,
40906174,0,18613,-307805,2016-09-13,2016-09-13,
40906174,333423,0,-641228,2016-09-14,2016-09-14,Bill Sharing
40906174,17672,0,-658900,2016-09-14,2016-09-14,Transportation
40906174,327750,0,-986650,2016-09-14,2016-09-14,Entertainment
40906174,14067,0,-1000717,2016-09-15,2016-09-15,Transportation
40906174,350766,0,-1351483,2016-09-15,2016-09-15,Utilities
40906174,401363,0,-1752846,2016-09-15,2016-09-15,Groceries
40906174,10032,0,-1762878,2016-09-16,2016-09-16,Clothes
40906174,0,406057,-1356821,2016-09-16,2016-09-16,
40906174,0,19637,-1337184,2016-09-16,2016-09-16,
40906174,368041,0,-1705225,2016-09-17,2016-09-17,Groceries
40906174,19042,0,-1724267,2016-09-17,2016-09-17,Bill Sharing
40906174,0,825391,-1707975,2016-09-18,2016-09-18,
40906174,729201,0,-1690206,2016-09-18,2016-09-18,Education
40906174,0,15548,-1674658,2016-09-19,2016-09-19,
40906174,0,394777,-1279881,2016-09-20,2016-09-20,
40906174,0,13399,-1266482,2016-09-20,2016-09-20,
40906174,10248,0,-1276730,2016-09-21,2016-09-21,Utilities
40906174,0,474824,-801906,2016-09-21,2016-09-21,
40906174,0,325347,-476559,2016-09-21,2016-09-21,
40906174,369266,0,-845825,2016-09-22,2016-09-22,Utilities
40906174,0,13383,-832442,2016-09-22,2016-09-22,
40906174,424927,0,-1257369,2016-09-23,2016-09-23,Healthcare
40906174,0,18871,-1238498,2016-09-23,2016-09-23,
40906174,441715,0,-1680213,2016-09-23,2016-09-23,Groceries
40906174,0,15669,-1664544,2016-09-24,2016-09-24,
40906174,0,373021,-1291523,2016-09-24,2016-09-24,
40906174,407556,0,-1699079,2016-09-25,2016-09-25,Groceries
40906174,0,15404,-1683675,2016-09-25,2016-09-25,
40906174,10893,0,-1694568,2016-09-25,2016-09-25,Clothes
40906174,0,15572,-1678996,2016-09-26,2016-09-26,
40906174,0,486039,-1192957,2016-09-26,2016-09-26,
40906174,497773,0,-1690730,2016-09-27,2016-09-27,Utilities
40906174,0,12342,-1678388,2016-09-27,2016-09-27,
40906174,419469,0,-2097857,2016-09-27,2016-09-27,Education
40906174,424403,0,-2522260,2016-09-28,2016-09-28,Education
40906174,16371,0,-2538631,2016-09-28,2016-09-28,Entertainment
40906174,422486,0,-2961117,2016-09-29,2016-09-29,Transportation
40906174,0,488773,-2472344,2016-09-29,2016-09-29,
40906174,0,583880,-2459248,2016-09-30,2016-09-30,
40906174,0,495145,-1964103,2016-09-30,2016-09-30,
40906174,0,333271,-1630832,2016-09-30,2016-09-30,
40906174,0,19917,-1610915,2016-10-01,2016-10-01,
40906174,0,19643,-1591272,2016-10-01,2016-10-01,
40906174,16556,0,-1607828,2016-10-02,2016-10-02,Utilities
40906174,466472,0,-2074300,2016-10-02,2016-10-02,Utilities
40906174,0,402972,-1671328,2016-10-02,2016-10-02,
40906174,0,347015,-1324313,2016-10-03,2016-10-03,
40906174,11840,0,-1336153,2016-10-03,2016-10-03,Bill Sharing
40906174,0,341700,-994453,2016-10-04,2016-10-04,
40906174,0,403390,-591063,2016-10-05,2016-10-05,
40906174,326017,0,-917080,2016-10-05,2016-10-05,Utilities
40906174,0,368134,-548946,2016-10-05,2016-10-05,
40906174,348017,0,-896963,2016-10-06,2016-10-06,Groceries
40906174,446627,0,-1343590,2016-10-07,2016-10-07,Clothes
40906174,15375,0,-1358965,2016-10-07,2016-10-07,Education
40906174,341228,0,-1700193,2016-10-08,2016-10-08,Education
40906174,0,310188,-1390005,2016-10-08,2016-10-08,
40906174,0,441803,-948202,2016-10-09,2016-10-09,
40906174,907587,0,-462391,2016-10-10,2016-10-10,Healthcare
40906174,0,397256,-65135,2016-10-10,2016-10-10,
40906174,18023,0,-83158,2016-10-11,2016-10-11,Rent
40906174,0,11201,-71957,2016-10-12,2016-10-12,
40906174,10250,0,-82207,2016-10-12,2016-10-12,Utilities
40906174,0,10041,-72166,2016-10-12,2016-10-12,
40906174,0,431163,-358997,2016-10-13,2016-10-13,
40906174,381828,0,-740825,2016-10-14,2016-10-14,Healthcare
40906174,12378,0,-753203,2016-10-14,2016-10-14,Education
40906174,0,10460,-742743,2016-10-14,2016-10-14,
40906174,13720,0,-756463,2016-10-15,2016-10-15,Bill Sharing
40906174,11891,0,-768354,2016-10-15,2016-10-15,Healthcare
40906174,395937,0,-1164291,2016-10-15,2016-10-15,Education
40906174,352770,0,-1517061,2016-10-16,2016-10-16,Healthcare
40906174,19209,0,-1536270,2016-10-17,2016-10-17,Clothes
40906174,12460,0,-1548730,2016-10-18,2016-10-18,Utilities
40906174,442788,0,-1991518,2016-10-18,2016-10-18,Bill Sharing
40906174,0,14024,-1977494,2016-10-19,2016-10-19,
40906174,0,413217,-1564277,2016-10-19,2016-10-19,
40906174,402223,0,-1966500,2016-10-19,2016-10-19,Education
40906174,430219,0,-2396719,2016-10-20,2016-10-20,Transportation
40906174,0,318980,-2077739,2016-10-20,2016-10-20,
40906174,0,316538,-1761201,2016-10-20,2016-10-20,
40906174,19714,0,-1780915,2016-10-21,2016-10-21,Healthcare
40906174,11958,0,-1792873,2016-10-21,2016-10-21,Education
40906174,0,13700,-1779173,2016-10-21,2016-10-21,
40906174,0,432746,-1346427,2016-10-22,2016-10-22,
40906174,12655,0,-1359082,2016-10-22,2016-10-22,Clothes
40906174,16953,0,-1376035,2016-10-23,2016-10-23,Groceries
40906174,0,17154,-1358881,2016-10-23,2016-10-23,
40906174,486588,0,-1845469,2016-10-24,2016-10-24,Clothes
40906174,377268,0,-2222737,2016-10-24,2016-10-24,Education
40906174,300031,0,-2522768,2016-10-24,2016-10-24,Entertainment
40906174,330769,0,-2853537,2016-10-25,2016-10-25,Bill Sharing
40906174,0,459045,-2394492,2016-10-25,2016-10-25,
40906174,0,19832,-2374660,2016-10-26,2016-10-26,
40906174,379978,0,-2754638,2016-10-26,2016-10-26,Healthcare
40906174,0,311693,-2442945,2016-10-27,2016-10-27,
40906174,0,15255,-2427690,2016-10-27,2016-10-27,
40906174,424806,0,-2852496,2016-10-28,2016-10-28,Entertainment
40906174,344155,0,-3196651,2016-10-29,2016-10-29,Transportation
40906174,0,915226,-2711333,2016-10-30,2016-10-30,
40906174,0,18220,-2693113,2016-10-30,2016-10-30,
40906174,314176,0,-3007289,2016-10-30,2016-10-30,Education
40906174,0,329408,-2677881,2016-10-31,2016-10-31,
40906174,305553,0,-2983434,2016-10-31,2016-10-31,Entertainment
40906174,453765,0,-3437199,2016-10-31,2016-10-31,Healthcare
40906174,0,15870,-3421329,2016-11-01,2016-11-01,
40906174,0,431171,-2990158,2016-11-01,2016-11-01,
40906174,494633,0,-3484791,2016-11-02,2016-11-02,Healthcare
40906174,12191,0,-3496982,2016-11-02,2016-11-02,Clothes
40906174,339886,0,-3836868,2016-11-02,2016-11-02,Utilities
40906174,413633,0,-4250501,2016-11-03,2016-11-03,Entertainment
40906174,0,310367,-3940134,2016-11-03,2016-11-03,
40906174,0,330518,-3609616,2016-11-03,2016-11-03,
40906174,406448,0,-4016064,2016-11-04,2016-11-04,Utilities
40906174,0,306856,-3709208,2016-11-05,2016-11-05,
40906174,453740,0,-4162948,2016-11-06,2016-11-06,Entertainment
40906174,0,13224,-4149724,2016-11-07,2016-11-07,
40906174,0,16675,-4133049,2016-11-07,2016-11-07,
40906174,0,12652,-4120397,2016-11-08,2016-11-08,
40906174,0,18379,-4102018,2016-11-08,2016-11-08,
40906174,314567,0,-4416585,2016-11-08,2016-11-08,Education
40906174,17930,0,-4434515,2016-11-09,2016-11-09,Rent
40906174,420831,0,-4855346,2016-11-09,2016-11-09,Healthcare
40906174,603766,0,-4840154,2016-11-09,2016-11-09,Education
40906174,0,11310,-4828844,2016-11-10,2016-11-10,
40906174,19243,0,-4848087,2016-11-10,2016-11-10,Rent
40906174,0,482611,-4365476,2016-11-10,2016-11-10,
40906174,480767,0,-4846243,2016-11-11,2016-11-11,Entertainment
40906174,370823,0,-5217066,2016-11-11,2016-11-11,Transportation
40906174,330430,0,-5547496,2016-11-11,2016-11-11,Healthcare
40906174,415845,0,-5963341,2016-11-12,2016-11-12,Entertainment
40906174,0,11781,-5951560,2016-11-13,2016-11-13,
40906174,0,359175,-5592385,2016-11-14,2016-11-14,
40906174,0,332165,-5260220,2016-11-14,2016-11-14,
40906174,353112,0,-5613332,2016-11-15,2016-11-15,Entertainment
40906174,0,436135,-5177197,2016-11-15,2016-11-15,
40906174,0,369880,-4807317,2016-11-16,2016-11-16,
40906174,475082,0,-5282399,2016-11-16,2016-11-16,Entertainment
40906174,0,410600,-4871799,2016-11-17,2016-11-17,
40906174,352189,0,-5223988,2016-11-17,2016-11-17,Healthcare
40906174,0,476013,-4747975,2016-11-17,2016-11-17,
40906174,0,495319,-4252656,2016-11-18,2016-11-18,
40906174,325644,0,-4578300,2016-11-18,2016-11-18,Healthcare
40906174,0,342056,-4236244,2016-11-18,2016-11-18,
40906174,0,315145,-3921099,2016-11-19,2016-11-19,
40906174,0,363176,-3557923,2016-11-19,2016-11-19,
40906174,487293,0,-4045216,2016-11-19,2016-11-19,Utilities
40906174,19570,0,-4064786,2016-11-20,2016-11-20,Clothes
40906174,327069,0,-4391855,2016-11-21,2016-11-21,Healthcare
40906174,19652,0,-4411507,2016-11-21,2016-11-21,Healthcare
40906174,319944,0,-4731451,2016-11-22,2016-11-22,Groceries
40906174,0,314603,-4416848,2016-11-23,2016-11-23,
40906174,11713,0,-4428561,2016-11-24,2016-11-24,Groceries
40906174,10472,0,-4439033,2016-11-24,2016-11-24,Healthcare
40906174,0,352143,-4086890,2016-11-24,2016-11-24,
40906174,10836,0,-4097726,2016-11-25,2016-11-25,Entertainment
40906174,0,17612,-4080114,2016-11-25,2016-11-25,
40906174,0,14109,-4066005,2016-11-26,2016-11-26,
40906174,17885,0,-4083890,2016-11-26,2016-11-26,Transportation
40906174,0,337096,-3746794,2016-11-27,2016-11-27,
40906174,306130,0,-4052924,2016-11-27,2016-11-27,Groceries
40906174,0,11477,-4041447,2016-11-28,2016-11-28,
40906174,0,16232,-4025215,2016-11-28,2016-11-28,
40906174,15255,0,-4040470,2016-11-28,2016-11-28,Entertainment
40906174,0,10726,-4029744,2016-11-29,2016-11-29,
40906174,371721,0,-4401465,2016-11-29,2016-11-29,Healthcare
40906174,16817,0,-4418282,2016-11-30,2016-11-30,Healthcare
40906174,0,398263,-4020019,2016-11-30,2016-11-30,
40906174,0,12890,-4007129,2016-12-01,2016-12-01,
40906174,0,462772,-3544357,2016-12-01,2016-12-01,
40906174,438876,0,-3983233,2016-12-02,2016-12-02,Rent
40906174,0,489604,-3493629,2016-12-02,2016-12-02,
40906174,625151,0,-3509094,2016-12-02,2016-12-02,Education
40906174,19485,0,-3528579,2016-12-03,2016-12-03,Education
40906174,0,18026,-3510553,2016-12-03,2016-12-03,
40906174,18503,0,-3529056,2016-12-04,2016-12-04,Rent
40906174,0,478588,-3050468,2016-12-04,2016-12-04,
40906174,0,10060,-3040408,2016-12-04,2016-12-04,
40906174,353303,0,-3393711,2016-12-05,2016-12-05,Bill Sharing
40906174,0,369357,-3024354,2016-12-06,2016-12-06,
40906174,0,13408,-3010946,2016-12-07,2016-12-07,
40906174,0,11290,-2999656,2016-12-07,2016-12-07,
40906174,0,13748,-2985908,2016-12-08,2016-12-08,
40906174,13000,0,-2998908,2016-12-08,2016-12-08,Education
40906174,0,433380,-2565528,2016-12-09,2016-12-09,
40906174,0,18659,-2546869,2016-12-10,2016-12-10,
40906174,364688,0,-2911557,2016-12-11,2016-12-11,Entertainment
40906174,0,17931,-2893626,2016-12-12,2016-12-12,
40906174,484484,0,-3378110,2016-12-13,2016-12-13,Healthcare
40906174,339758,0,-3717868,2016-12-14,2016-12-14,Rent
40906174,14591,0,-3732459,2016-12-15,2016-12-15,Education
40906174,406549,0,-4139008,2016-12-15,2016-12-15,Healthcare
40906174,0,304781,-3834227,2016-12-16,2016-12-16,
40906174,780514,0,-3850976,2016-12-16,2016-12-16,Healthcare
40906174,13557,0,-3864533,2016-12-16,2016-12-16,Transportation
40906174,409333,0,-4273866,2016-12-17,2016-12-17,Healthcare
40906174,0,12993,-4260873,2016-12-18,2016-12-18,
40906174,0,12774,-4248099,2016-12-18,2016-12-18,
40906174,0,451596,-3796503,2016-12-19,2016-12-19,
40906174,19467,0,-3815970,2016-12-19,2016-12-19,Healthcare
40906174,19532,0,-3835502,2016-12-19,2016-12-19,Groceries
40906174,17318,0,-3852820,2016-12-20,2016-12-20,Utilities
40906174,0,876066,-3870815,2016-12-20,2016-12-20,
40906174,11444,0,-3882259,2016-12-21,2016-12-21,Entertainment
40906174,0,13953,-3868306,2016-12-21,2016-12-21,
40906174,493653,0,-4361959,2016-12-22,2016-12-22,Clothes
40906174,0,12770,-4349189,2016-12-22,2016-12-22,
40906174,463837,0,-4813026,2016-12-22,2016-12-22,Transportation
40906174,365144,0,-5178170,2016-12-23,2016-12-23,Utilities
40906174,0,484216,-4693954,2016-12-23,2016-12-23,
40906174,0,11259,-4682695,2016-12-24,2016-12-24,
40906174,372566,0,-5055261,2016-12-25,2016-12-25,Healthcare
40906174,0,10492,-5044769,2016-12-25,2016-12-25,
40906174,820922,0,-5404779,2016-12-25,2016-12-25,Education
40906174,18922,0,-5423701,2016-12-26,2016-12-26,Healthcare
40906174,0,460149,-4963552,2016-12-26,2016-12-26,
40906174,0,356444,-4607108,2016-12-26,2016-12-26,
40906174,488973,0,-5096081,2016-12-27,2016-12-27,Entertainment
40906174,0,579029,-5561549,2016-12-28,2016-12-28,
40906174,13599,0,-5575148,2016-12-29,2016-12-29,Transportation
40906174,482171,0,-6057319,2016-12-29,2016-12-29,Education
40906174,13774,0,-6071093,2016-12-30,2016-12-30,Entertainment
40906174,16914,0,-6088007,2016-12-30,2016-12-30,Transportation
40906174,344787,0,-6432794,2016-12-30,2016-12-30,Rent
40906174,19353,0,-6452147,2016-12-31,2016-12-31,Education
40906174,19026,0,-6471173,2016-12-31,2016-12-31,Rent
40906174,0,14150,-6457023,2017-01-01,2017-01-01,
40906174,0,17079,-6439944,2017-01-02,2017-01-02,
40906174,0,19640,-6420304,2017-01-02,2017-01-02,
40906174,0,332768,-6087536,2017-01-03,2017-01-03,
40906174,0,401246,-5686290,2017-01-04,2017-01-04,
40906174,405149,0,-6091439,2017-01-05,2017-01-05,Rent
40906174,0,14092,-6077347,2017-01-05,2017-01-05,
40906174,618207,0,-5702862,2017-01-06,2017-01-06,Education
40906174,344734,0,-6047596,2017-01-06,2017-01-06,Entertainment
40906174,0,840999,-5630103,2017-01-07,2017-01-07,
40906174,0,440951,-5189152,2017-01-07,2017-01-07,
40906174,361497,0,-5550649,2017-01-08,2017-01-08,Groceries
40906174,0,493866,-5056783,2017-01-08,2017-01-08,
40906174,16465,0,-5073248,2017-01-08,2017-01-08,Utilities
40906174,12392,0,-5085640,2017-01-09,2017-01-09,Groceries
40906174,12896,0,-5098536,2017-01-09,2017-01-09,Bill Sharing
40906174,0,15843,-5082693,2017-01-09,2017-01-09,
40906174,437595,0,-5520288,2017-01-10,2017-01-10,Entertainment
40906174,435733,0,-5956021,2017-01-10,2017-01-10,Rent
40906174,880666,0,-6393899,2017-01-11,2017-01-11,Education
40906174,0,382577,-6011322,2017-01-11,2017-01-11,
40906174,414358,0,-6425680,2017-01-11,2017-01-11,Transportation
40906174,410850,0,-6836530,2017-01-12,2017-01-12,Groceries
40906174,483770,0,-7320300,2017-01-12,2017-01-12,Education
40906174,0,359695,-6960605,2017-01-13,2017-01-13,
40906174,350188,0,-7310793,2017-01-13,2017-01-13,Transportation
40906174,0,303993,-7006800,2017-01-14,2017-01-14,
40906174,18919,0,-7025719,2017-01-14,2017-01-14,Rent
40906174,0,333759,-6691960,2017-01-15,2017-01-15,
40906174,484686,0,-7176646,2017-01-16,2017-01-16,Clothes
40906174,0,372996,-6803650,2017-01-16,2017-01-16,
40906174,0,358199,-6445451,2017-01-16,2017-01-16,
40906174,0,18682,-6426769,2017-01-17,2017-01-17,
40906174,473072,0,-6899841,2017-01-17,2017-01-17,Rent
40906174,0,453054,-6446787,2017-01-17,2017-01-17,
40906174,0,11002,-6435785,2017-01-18,2017-01-18,
40906174,457543,0,-6893328,2017-01-19,2017-01-19,Transportation
40906174,0,19366,-6873962,2017-01-19,2017-01-19,
40906174,396962,0,-7270924,2017-01-20,2017-01-20,Entertainment
40906174,12252,0,-7283176,2017-01-20,2017-01-20,Rent
40906174,0,401229,-6881947,2017-01-20,2017-01-20,
40906174,0,13932,-6868015,2017-01-21,2017-01-21,
40906174,11016,0,-6879031,2017-01-22,2017-01-22,Healthcare
40906174,380803,0,-7259834,2017-01-22,2017-01-22,Entertainment
40906174,0,17802,-7242032,2017-01-22,2017-01-22,
40906174,0,19597,-7222435,2017-01-23,2017-01-23,
40906174,19387,0,-7241822,2017-01-24,2017-01-24,Bill Sharing
40906174,18125,0,-7259947,2017-01-25,2017-01-25,Education
40906174,0,442736,-6817211,2017-01-26,2017-01-26,
40906174,402423,0,-7219634,2017-01-26,2017-01-26,Bill Sharing
40906174,0,14820,-7204814,2017-01-27,2017-01-27,
40906174,0,18155,-7186659,2017-01-27,2017-01-27,
40906174,445157,0,-7631816,2017-01-27,2017-01-27,Transportation
40906174,0,488892,-7142924,2017-01-28,2017-01-28,
40906174,449667,0,-7592591,2017-01-28,2017-01-28,Clothes
40906174,437019,0,-8029610,2017-01-28,2017-01-28,Healthcare
40906174,0,16409,-8013201,2017-01-29,2017-01-29,
40906174,18544,0,-8031745,2017-01-29,2017-01-29,Entertainment
40906174,0,19687,-8012058,2017-01-29,2017-01-29,
40906174,14586,0,-8026644,2017-01-30,2017-01-30,Groceries
40906174,0,348776,-7677868,2017-01-31,2017-01-31,
40906174,15269,0,-7693137,2017-01-31,2017-01-31,Rent
40906174,0,421313,-7271824,2017-02-01,2017-02-01,
40906174,0,17149,-7254675,2017-02-01,2017-02-01,
40906174,0,342017,-6912658,2017-02-01,2017-02-01,
40906174,0,18698,-6893960,2017-02-02,2017-02-02,
40906174,0,448704,-6445256,2017-02-03,2017-02-03,
40906174,0,440503,-6004753,2017-02-03,2017-02-03,
40906174,0,360534,-5644219,2017-02-03,2017-02-03,
40906174,19005,0,-5663224,2017-02-04,2017-02-04,Bill Sharing
40906174,485158,0,-6148382,2017-02-04,2017-02-04,Groceries
40906174,13131,0,-6161513,2017-02-05,2017-02-05,Rent
40906174,382561,0,-6544074,2017-02-05,2017-02-05,Healthcare
40906174,407132,0,-6951206,2017-02-05,2017-02-05,Rent
40906174,401278,0,-7352484,2017-02-06,2017-02-06,Healthcare
40906174,0,12449,-7340035,2017-02-06,2017-02-06,
40906174,0,14768,-7325267,2017-02-06,2017-02-06,
40906174,0,19518,-7305749,2017-02-07,2017-02-07,
40906174,0,490245,-6815504,2017-02-07,2017-02-07,
40906174,313087,0,-7128591,2017-02-07,2017-02-07,Clothes
40906174,17780,0,-7146371,2017-02-08,2017-02-08,Clothes
40906174,449669,0,-7596040,2017-02-08,2017-02-08,Transportation
40906174,0,300548,-7295492,2017-02-09,2017-02-09,
40906174,11863,0,-7307355,2017-02-09,2017-02-09,Rent
40906174,0,308223,-6999132,2017-02-10,2017-02-10,
40906174,420665,0,-7419797,2017-02-10,2017-02-10,Bill Sharing
40906174,0,19419,-7400378,2017-02-10,2017-02-10,
40906174,16852,0,-7417230,2017-02-11,2017-02-11,Utilities
40906174,0,393002,-7024228,2017-02-11,2017-02-11,
40906174,14061,0,-7038289,2017-02-11,2017-02-11,Bill Sharing
40906174,0,432589,-6605700,2017-02-12,2017-02-12,
40906174,494716,0,-7100416,2017-02-12,2017-02-12,Utilities
40906174,397440,0,-7497856,2017-02-13,2017-02-13,Education
40906174,306482,0,-7804338,2017-02-13,2017-02-13,Clothes
40906174,0,10437,-7793901,2017-02-14,2017-02-14,
40906174,488897,0,-8282798,2017-02-14,2017-02-14,Rent
40906174,19170,0,-8301968,2017-02-14,2017-02-14,Education
40906174,17795,0,-8319763,2017-02-15,2017-02-15,Groceries
40906174,0,16944,-8302819,2017-02-15,2017-02-15,
40906174,0,17137,-8285682,2017-02-15,2017-02-15,
40906174,0,16871,-8268811,2017-02-16,2017-02-16,
40906174,488802,0,-8757613,2017-02-17,2017-02-17,Rent
40906174,0,400421,-8357192,2017-02-18,2017-02-18,
40906174,0,327986,-8029206,2017-02-19,2017-02-19,
40906174,18036,0,-8047242,2017-02-20,2017-02-20,Bill Sharing
40906174,0,354976,-7692266,2017-02-20,2017-02-20,
40906174,15274,0,-7707540,2017-02-21,2017-02-21,Groceries
40906174,0,19059,-7688481,2017-02-21,2017-02-21,
40906174,13772,0,-7702253,2017-02-21,2017-02-21,Entertainment
40906174,386202,0,-8088455,2017-02-22,2017-02-22,Entertainment
40906174,470817,0,-8559272,2017-02-22,2017-02-22,Entertainment
40906174,0,340252,-8219020,2017-02-23,2017-02-23,
40906174,0,429225,-7789795,2017-02-23,2017-02-23,
40906174,328061,0,-8117856,2017-02-24,2017-02-24,Utilities
40906174,0,413394,-7704462,2017-02-24,2017-02-24,
40906174,0,477033,-7227429,2017-02-25,2017-02-25,
40906174,0,406922,-6820507,2017-02-25,2017-02-25,
40906174,18062,0,-6838569,2017-02-26,2017-02-26,Transportation
40906174,12398,0,-6850967,2017-02-26,2017-02-26,Groceries
40906174,18536,0,-6869503,2017-02-26,2017-02-26,Education
40906174,19355,0,-6888858,2017-02-27,2017-02-27,Rent
40906174,0,12226,-6876632,2017-02-27,2017-02-27,
40906174,326212,0,-7202844,2017-02-28,2017-02-28,Utilities
40906174,12268,0,-7215112,2017-02-28,2017-02-28,Clothes
40906174,0,15448,-7199664,2017-03-01,2017-03-01,
40906174,0,413770,-6785894,2017-03-01,2017-03-01,
40906174,0,335071,-6450823,2017-03-02,2017-03-02,
40906174,0,18288,-6432535,2017-03-02,2017-03-02,
40906174,0,322118,-6110417,2017-03-03,2017-03-03,
40906174,0,13274,-6097143,2017-03-04,2017-03-04,
40906174,12954,0,-6110097,2017-03-04,2017-03-04,Utilities
40906174,0,464398,-5645699,2017-03-05,2017-03-05,
40906174,0,13678,-5632021,2017-03-06,2017-03-06,
40906174,484177,0,-6116198,2017-03-07,2017-03-07,Bill Sharing
40906174,0,354482,-5761716,2017-03-07,2017-03-07,
40906174,472258,0,-6233974,2017-03-08,2017-03-08,Healthcare
40906174,0,16336,-6217638,2017-03-08,2017-03-08,
40906174,446153,0,-6663791,2017-03-09,2017-03-09,Entertainment
40906174,0,322629,-6341162,2017-03-09,2017-03-09,
40906174,470866,0,-6812028,2017-03-10,2017-03-10,Rent
40906174,19699,0,-6831727,2017-03-11,2017-03-11,Clothes
40906174,0,18650,-6813077,2017-03-11,2017-03-11,
40906174,12000,0,-6825077,2017-03-12,2017-03-12,Rent
40906174,0,401045,-6424032,2017-03-12,2017-03-12,
40906174,0,435842,-5988190,2017-03-12,2017-03-12,
40906174,412360,0,-6400550,2017-03-13,2017-03-13,Utilities
40906174,0,435870,-5964680,2017-03-13,2017-03-13,
40906174,13344,0,-5978024,2017-03-14,2017-03-14,Entertainment
40906174,0,854490,-6309137,2017-03-15,2017-03-15,
40906174,17430,0,-6326567,2017-03-16,2017-03-16,Clothes
40906174,0,18571,-6307996,2017-03-16,2017-03-16,
40906174,0,328844,-5979152,2017-03-17,2017-03-17,
40906174,10140,0,-5989292,2017-03-18,2017-03-18,Transportation
40906174,304478,0,-6293770,2017-03-18,2017-03-18,Bill Sharing
40906174,0,18592,-6275178,2017-03-19,2017-03-19,
40906174,0,10887,-6264291,2017-03-20,2017-03-20,
40906174,0,13298,-6250993,2017-03-21,2017-03-21,
40906174,345682,0,-6596675,2017-03-21,2017-03-21,Education
40906174,13382,0,-6610057,2017-03-21,2017-03-21,Education
40906174,0,19219,-6590838,2017-03-22,2017-03-22,
40906174,0,10535,-6580303,2017-03-22,2017-03-22,
40906174,10051,0,-6590354,2017-03-22,2017-03-22,Clothes
40906174,0,362129,-6228225,2017-03-23,2017-03-23,
40906174,0,421777,-5806448,2017-03-24,2017-03-24,
40906174,0,469369,-5337079,2017-03-24,2017-03-24,
40906174,13834,0,-5350913,2017-03-24,2017-03-24,Education
40906174,0,476156,-4874757,2017-03-25,2017-03-25,
40906174,499751,0,-5374508,2017-03-25,2017-03-25,Groceries
40906174,480954,0,-5855462,2017-03-25,2017-03-25,Utilities
40906174,0,18339,-5837123,2017-03-26,2017-03-26,
40906174,463472,0,-6300595,2017-03-26,2017-03-26,Clothes
40906174,339026,0,-6639621,2017-03-27,2017-03-27,Rent
40906174,15969,0,-6655590,2017-03-28,2017-03-28,Utilities
40906174,0,10356,-6645234,2017-03-28,2017-03-28,
40906174,347368,0,-6992602,2017-03-29,2017-03-29,Entertainment
40906174,18004,0,-7010606,2017-03-29,2017-03-29,Utilities
40906174,12756,0,-7023362,2017-03-30,2017-03-30,Healthcare
40906174,14852,0,-7038214,2017-03-30,2017-03-30,Utilities
40906174,0,16287,-7021927,2017-03-31,2017-03-31,
40906174,367575,0,-7389502,2017-04-01,2017-04-01,Education
40906174,0,15487,-7374015,2017-04-02,2017-04-02,
40906174,0,15687,-7358328,2017-04-03,2017-04-03,
40906174,0,430828,-6927500,2017-04-03,2017-04-03,
40906174,0,464586,-6462914,2017-04-03,2017-04-03,
40906174,0,567453,-6893752,2017-04-04,2017-04-04,
40906174,424601,0,-7318353,2017-04-04,2017-04-04,Bill Sharing
40906174,0,13199,-7305154,2017-04-04,2017-04-04,
40906174,0,12496,-7292658,2017-04-05,2017-04-05,
40906174,0,351471,-6941187,2017-04-05,2017-04-05,
40906174,0,538317,-6921790,2017-04-06,2017-04-06,
40906174,13419,0,-6935209,2017-04-07,2017-04-07,Healthcare
40906174,15858,0,-6951067,2017-04-08,2017-04-08,Bill Sharing
40906174,0,13511,-6937556,2017-04-08,2017-04-08,
40906174,988071,0,-7264815,2017-04-09,2017-04-09,Education
40906174,313127,0,-7577942,2017-04-10,2017-04-10,Groceries
40906174,0,13398,-7564544,2017-04-11,2017-04-11,
40906174,0,327703,-7236841,2017-04-11,2017-04-11,
40906174,419662,0,-7656503,2017-04-11,2017-04-11,Healthcare
40906174,429669,0,-8086172,2017-04-12,2017-04-12,Transportation
40906174,0,408307,-7677865,2017-04-12,2017-04-12,
40906174,14010,0,-7691875,2017-04-13,2017-04-13,Clothes
40906174,13009,0,-7704884,2017-04-14,2017-04-14,Clothes
40906174,0,333981,-7370903,2017-04-14,2017-04-14,
40906174,16944,0,-7387847,2017-04-15,2017-04-15,Healthcare
40906174,0,19749,-7368098,2017-04-15,2017-04-15,
40906174,15043,0,-7383141,2017-04-15,2017-04-15,Healthcare
40906174,14855,0,-7397996,2017-04-16,2017-04-16,Rent
40906174,0,386391,-7011605,2017-04-17,2017-04-17,
40906174,0,445531,-6566074,2017-04-17,2017-04-17,
40906174,11275,0,-6577349,2017-04-17,2017-04-17,Education
40906174,0,524792,-7020369,2017-04-18,2017-04-18,
40906174,16631,0,-7037000,2017-04-18,2017-04-18,Healthcare
40906174,310882,0,-7347882,2017-04-19,2017-04-19,Healthcare
40906174,0,755219,-7364665,2017-04-19,2017-04-19,
40906174,435325,0,-7799990,2017-04-19,2017-04-19,Groceries
40906174,0,19961,-7780029,2017-04-20,2017-04-20,
40906174,383943,0,-8163972,2017-04-20,2017-04-20,Bill Sharing
40906174,0,360580,-7803392,2017-04-21,2017-04-21,
40906174,0,494440,-7308952,2017-04-21,2017-04-21,
40906174,0,367857,-6941095,2017-04-21,2017-04-21,
40906174,0,412668,-6528427,2017-04-22,2017-04-22,
40906174,0,325944,-6202483,2017-04-23,2017-04-23,
40906174,418821,0,-6621304,2017-04-23,2017-04-23,Bill Sharing
40906174,367748,0,-6989052,2017-04-23,2017-04-23,Rent
40906174,0,18064,-6970988,2017-04-24,2017-04-24,
40906174,0,18001,-6952987,2017-04-24,2017-04-24,
40906174,0,436565,-6516422,2017-04-24,2017-04-24,
40906174,452566,0,-6968988,2017-04-25,2017-04-25,Transportation
40906174,0,466795,-6502193,2017-04-25,2017-04-25,
40906174,17709,0,-6519902,2017-04-25,2017-04-25,Groceries
40906174,0,333622,-6186280,2017-04-26,2017-04-26,
40906174,484697,0,-6670977,2017-04-26,2017-04-26,Transportation
40906174,16463,0,-6687440,2017-04-27,2017-04-27,Transportation
40906174,351664,0,-7039104,2017-04-27,2017-04-27,Groceries
40906174,12293,0,-7051397,2017-04-27,2017-04-27,Bill Sharing
40906174,0,12438,-7038959,2017-04-28,2017-04-28,
40906174,19709,0,-7058668,2017-04-28,2017-04-28,Utilities
40906174,17503,0,-7076171,2017-04-28,2017-04-28,Clothes
40906174,11079,0,-7087250,2017-04-29,2017-04-29,Rent
40906174,12766,0,-7100016,2017-04-29,2017-04-29,Education
40906174,0,10816,-7089200,2017-04-30,2017-04-30,
40906174,0,15717,-7073483,2017-04-30,2017-04-30,
40906174,10892,0,-7084375,2017-04-30,2017-04-30,Transportation
40906174,377538,0,-7461913,2017-05-01,2017-05-01,Rent
40906174,0,10607,-7451306,2017-05-01,2017-05-01,
40906174,619656,0,-7805401,2017-05-02,2017-05-02,Healthcare
40906174,12879,0,-7818280,2017-05-03,2017-05-03,Utilities
40906174,0,16458,-7801822,2017-05-04,2017-05-04,
40906174,0,380463,-7421359,2017-05-05,2017-05-05,
40906174,458709,0,-7880068,2017-05-05,2017-05-05,Groceries
40906174,0,394479,-7485589,2017-05-06,2017-05-06,
40906174,0,424930,-7060659,2017-05-06,2017-05-06,
40906174,14044,0,-7074703,2017-05-07,2017-05-07,Utilities
40906174,432249,0,-7506952,2017-05-07,2017-05-07,Clothes
40906174,0,419729,-7087223,2017-05-07,2017-05-07,
40906174,14213,0,-7101436,2017-05-08,2017-05-08,Healthcare
40906174,18624,0,-7120060,2017-05-08,2017-05-08,Transportation
40906174,19513,0,-7139573,2017-05-08,2017-05-08,Bill Sharing
40906174,0,11774,-7127799,2017-05-09,2017-05-09,
40906174,0,494571,-6633228,2017-05-10,2017-05-10,
40906174,0,11092,-6622136,2017-05-10,2017-05-10,
40906174,10167,0,-6632303,2017-05-10,2017-05-10,Rent
40906174,0,357406,-6274897,2017-05-11,2017-05-11,
40906174,442755,0,-6717652,2017-05-11,2017-05-11,Rent
40906174,346223,0,-7063875,2017-05-12,2017-05-12,Bill Sharing
40906174,14915,0,-7078790,2017-05-13,2017-05-13,Bill Sharing
40906174,416984,0,-7495774,2017-05-14,2017-05-14,Entertainment
40906174,327781,0,-7823555,2017-05-15,2017-05-15,Entertainment
40906174,15580,0,-7839135,2017-05-15,2017-05-15,Bill Sharing
40906174,14936,0,-7854071,2017-05-15,2017-05-15,Groceries
40906174,355014,0,-8209085,2017-05-16,2017-05-16,Clothes
40906174,0,370693,-7838392,2017-05-17,2017-05-17,
40906174,17943,0,-7856335,2017-05-17,2017-05-17,Utilities
40906174,0,16963,-7839372,2017-05-17,2017-05-17,
40906174,0,16371,-7823001,2017-05-18,2017-05-18,
40906174,447269,0,-8270270,2017-05-18,2017-05-18,Utilities
40906174,0,16467,-8253803,2017-05-19,2017-05-19,
40906174,0,16926,-8236877,2017-05-19,2017-05-19,
40906174,474683,0,-8711560,2017-05-19,2017-05-19,Healthcare
40906174,300672,0,-9012232,2017-05-20,2017-05-20,Clothes
40906174,0,471984,-8540248,2017-05-20,2017-05-20,
40906174,11535,0,-8551783,2017-05-20,2017-05-20,Groceries
40906174,0,381950,-8169833,2017-05-21,2017-05-21,
40906174,324316,0,-8494149,2017-05-21,2017-05-21,Utilities
40906174,0,12282,-8481867,2017-05-21,2017-05-21,
40906174,15201,0,-8497068,2017-05-22,2017-05-22,Groceries
40906174,348982,0,-8846050,2017-05-22,2017-05-22,Entertainment
40906174,0,19187,-8826863,2017-05-23,2017-05-23,
40906174,15946,0,-8842809,2017-05-24,2017-05-24,Rent
40906174,721047,0,-8366811,2017-05-24,2017-05-24,Education
40906174,305602,0,-8672413,2017-05-24,2017-05-24,Entertainment
40906174,360002,0,-9032415,2017-05-25,2017-05-25,Utilities
40906174,495325,0,-9527740,2017-05-25,2017-05-25,Utilities
40906174,373216,0,-9900956,2017-05-25,2017-05-25,Groceries
40906174,352774,0,-10253730,2017-05-26,2017-05-26,Rent
40906174,0,15324,-10238406,2017-05-26,2017-05-26,
40906174,0,18611,-10219795,2017-05-26,2017-05-26,
40906174,0,412920,-9806875,2017-05-27,2017-05-27,
40906174,384422,0,-10191297,2017-05-27,2017-05-27,Education
40906174,19503,0,-10210800,2017-05-27,2017-05-27,Groceries
40906174,0,388924,-9821876,2017-05-28,2017-05-28,
40906174,0,496082,-9325794,2017-05-28,2017-05-28,
40906174,462932,0,-9788726,2017-05-29,2017-05-29,Bill Sharing
40906174,844610,0,-10183922,2017-05-29,2017-05-29,Education
40906174,381364,0,-10565286,2017-05-30,2017-05-30,Rent
40906174,0,402973,-10162313,2017-05-30,2017-05-30,
40906174,311720,0,-10474033,2017-05-30,2017-05-30,Clothes
40906174,0,11815,-10462218,2017-05-31,2017-05-31,
40906174,0,381691,-10080527,2017-05-31,2017-05-31,
40906174,484490,0,-10565017,2017-05-31,2017-05-31,Clothes
40906174,0,412266,-10152751,2017-06-01,2017-06-01,
40906174,18104,0,-10170855,2017-06-02,2017-06-02,Rent
40906174,0,16351,-10154504,2017-06-02,2017-06-02,
40906174,0,480002,-9674502,2017-06-02,2017-06-02,
40906174,393776,0,-10068278,2017-06-03,2017-06-03,Rent
40906174,12957,0,-10081235,2017-06-03,2017-06-03,Education
40906174,339399,0,-10420634,2017-06-04,2017-06-04,Transportation
40906174,0,313236,-10107398,2017-06-04,2017-06-04,
40906174,0,473904,-9633494,2017-06-04,2017-06-04,
40906174,0,499511,-9133983,2017-06-05,2017-06-05,
40906174,388053,0,-9522036,2017-06-05,2017-06-05,Entertainment
40906174,0,397000,-9125036,2017-06-06,2017-06-06,
40906174,11656,0,-9136692,2017-06-06,2017-06-06,Education
40906174,496736,0,-9633428,2017-06-07,2017-06-07,Healthcare
40906174,0,305726,-9327702,2017-06-07,2017-06-07,
40906174,414033,0,-9741735,2017-06-07,2017-06-07,Clothes
40906174,348775,0,-10090510,2017-06-08,2017-06-08,Transportation
40906174,329205,0,-10419715,2017-06-08,2017-06-08,Transportation
40906174,0,423061,-9996654,2017-06-09,2017-06-09,
40906174,19656,0,-10016310,2017-06-10,2017-06-10,Groceries
40906174,349944,0,-10366254,2017-06-11,2017-06-11,Utilities
40906174,306039,0,-10672293,2017-06-12,2017-06-12,Entertainment
40906174,0,396115,-10276178,2017-06-12,2017-06-12,
40906174,10153,0,-10286331,2017-06-12,2017-06-12,Rent
40906174,393915,0,-10680246,2017-06-13,2017-06-13,Education
40906174,0,15891,-10664355,2017-06-13,2017-06-13,
40906174,0,504452,-10652370,2017-06-13,2017-06-13,
40906174,13431,0,-10665801,2017-06-14,2017-06-14,Entertainment
40906174,402725,0,-11068526,2017-06-15,2017-06-15,Healthcare
40906174,0,424766,-10643760,2017-06-16,2017-06-16,
40906174,16517,0,-10660277,2017-06-17,2017-06-17,Education
40906174,0,492391,-10167886,2017-06-17,2017-06-17,
40906174,0,11024,-10156862,2017-06-17,2017-06-17,
40906174,17181,0,-10174043,2017-06-18,2017-06-18,Utilities
40906174,438224,0,-10612267,2017-06-18,2017-06-18,Utilities
40906174,12049,0,-10624316,2017-06-18,2017-06-18,Clothes
40906174,0,19066,-10605250,2017-06-19,2017-06-19,
40906174,0,18086,-10587164,2017-06-19,2017-06-19,
40906174,12522,0,-10599686,2017-06-20,2017-06-20,Groceries
40906174,0,325939,-10273747,2017-06-20,2017-06-20,
40906174,423186,0,-10696933,2017-06-21,2017-06-21,Healthcare
40906174,400528,0,-11097461,2017-06-22,2017-06-22,Clothes
40906174,0,378569,-10718892,2017-06-22,2017-06-22,
40906174,0,19330,-10699562,2017-06-22,2017-06-22,
40906174,11589,0,-10711151,2017-06-23,2017-06-23,Clothes
40906174,303005,0,-11014156,2017-06-24,2017-06-24,Education
40906174,0,397891,-10616265,2017-06-24,2017-06-24,
40906174,0,385842,-10230423,2017-06-25,2017-06-25,
40906174,0,399504,-9830919,2017-06-25,2017-06-25,
40906174,0,335886,-9495033,2017-06-26,2017-06-26,
40906174,19734,0,-9514767,2017-06-26,2017-06-26,Healthcare
40906174,0,791486,-9497017,2017-06-27,2017-06-27,
40906174,0,18940,-9478077,2017-06-27,2017-06-27,
40906174,16656,0,-9494733,2017-06-27,2017-06-27,Education
40906174,436369,0,-9931102,2017-06-28,2017-06-28,Groceries
40906174,0,17165,-9913937,2017-06-28,2017-06-28,
40906174,13260,0,-9927197,2017-06-28,2017-06-28,Groceries
40906174,0,15528,-9911669,2017-06-29,2017-06-29,
40906174,481432,0,-10393101,2017-06-29,2017-06-29,Education
40906174,0,440268,-9952833,2017-06-30,2017-06-30,
40906174,0,11409,-9941424,2017-07-01,2017-07-01,
40906174,0,338712,-9602712,2017-07-01,2017-07-01,
40906174,0,16775,-9585937,2017-07-02,2017-07-02,
40906174,18102,0,-9604039,2017-07-02,2017-07-02,Entertainment
40906174,0,13890,-9590149,2017-07-02,2017-07-02,
40906174,0,16939,-9573210,2017-07-03,2017-07-03,
40906174,426118,0,-9999328,2017-07-03,2017-07-03,Entertainment
40906174,0,394031,-9605297,2017-07-04,2017-07-04,
40906174,12793,0,-9618090,2017-07-04,2017-07-04,Healthcare
40906174,13534,0,-9631624,2017-07-05,2017-07-05,Education
40906174,11564,0,-9643188,2017-07-06,2017-07-06,Transportation
40906174,0,454731,-9188457,2017-07-07,2017-07-07,
40906174,0,16538,-9171919,2017-07-07,2017-07-07,
40906174,430764,0,-9602683,2017-07-08,2017-07-08,Bill Sharing
40906174,13073,0,-9615756,2017-07-09,2017-07-09,Utilities
40906174,12928,0,-9628684,2017-07-09,2017-07-09,Rent
40906174,0,16787,-9611897,2017-07-09,2017-07-09,
40906174,0,19270,-9592627,2017-07-10,2017-07-10,
40906174,0,477214,-9115413,2017-07-11,2017-07-11,
40906174,0,16992,-9098421,2017-07-12,2017-07-12,
40906174,13436,0,-9111857,2017-07-13,2017-07-13,Entertainment
40906174,0,668108,-9472236,2017-07-14,2017-07-14,
40906174,0,484546,-8987690,2017-07-14,2017-07-14,
40906174,450702,0,-9438392,2017-07-15,2017-07-15,Groceries
40906174,0,18292,-9420100,2017-07-15,2017-07-15,
40906174,0,494126,-8925974,2017-07-16,2017-07-16,
40906174,0,12212,-8913762,2017-07-16,2017-07-16,
40906174,387563,0,-9301325,2017-07-17,2017-07-17,Rent
40906174,0,10465,-9290860,2017-07-17,2017-07-17,
40906174,0,10929,-9279931,2017-07-17,2017-07-17,
40906174,0,401214,-8878717,2017-07-18,2017-07-18,
40906174,0,11039,-8867678,2017-07-18,2017-07-18,
40906174,19468,0,-8887146,2017-07-19,2017-07-19,Rent
40906174,0,473431,-8413715,2017-07-20,2017-07-20,
40906174,464122,0,-8877837,2017-07-20,2017-07-20,Healthcare
40906174,0,372061,-8505776,2017-07-20,2017-07-20,
40906174,373925,0,-8879701,2017-07-21,2017-07-21,Education
40906174,0,11260,-8868441,2017-07-21,2017-07-21,
40906174,10933,0,-8879374,2017-07-21,2017-07-21,Healthcare
40906174,19832,0,-8899206,2017-07-22,2017-07-22,Healthcare
40906174,843689,0,-8886904,2017-07-23,2017-07-23,Healthcare
40906174,410261,0,-9297165,2017-07-24,2017-07-24,Rent
40906174,0,17684,-9279481,2017-07-24,2017-07-24,
40906174,0,375134,-8904347,2017-07-24,2017-07-24,
40906174,0,366835,-8537512,2017-07-25,2017-07-25,
40906174,0,17638,-8519874,2017-07-25,2017-07-25,
40906174,447315,0,-8967189,2017-07-25,2017-07-25,Rent
40906174,13317,0,-8980506,2017-07-26,2017-07-26,Groceries
40906174,0,15098,-8965408,2017-07-27,2017-07-27,
40906174,0,424166,-8541242,2017-07-27,2017-07-27,
40906174,0,366143,-8175099,2017-07-28,2017-07-28,
40906174,12351,0,-8187450,2017-07-29,2017-07-29,Healthcare
40906174,869091,0,-8516522,2017-07-29,2017-07-29,Healthcare
40906174,0,13272,-8503250,2017-07-30,2017-07-30,
40906174,0,493577,-8009673,2017-07-31,2017-07-31,
40906174,0,336038,-7673635,2017-07-31,2017-07-31,
40906174,0,14412,-7659223,2017-08-01,2017-08-01,
40906174,0,13235,-7645988,2017-08-02,2017-08-02,
40906174,0,11991,-7633997,2017-08-02,2017-08-02,
40906174,16474,0,-7650471,2017-08-02,2017-08-02,Healthcare
40906174,0,13538,-7636933,2017-08-03,2017-08-03,
40906174,424425,0,-8061358,2017-08-04,2017-08-04,Transportation
40906174,0,339906,-7721452,2017-08-04,2017-08-04,
40906174,623633,0,-7704600,2017-08-04,2017-08-04,Healthcare
40906174,0,421222,-7283378,2017-08-05,2017-08-05,
40906174,388680,0,-7672058,2017-08-06,2017-08-06,Bill Sharing
40906174,10566,0,-7682624,2017-08-07,2017-08-07,Clothes
40906174,988644,0,-7671060,2017-08-08,2017-08-08,Education
40906174,0,444481,-7226579,2017-08-08,2017-08-08,
40906174,0,327795,-6898784,2017-08-09,2017-08-09,
40906174,0,485448,-6413336,2017-08-09,2017-08-09,
40906174,10855,0,-6424191,2017-08-10,2017-08-10,Utilities
40906174,460453,0,-6884644,2017-08-10,2017-08-10,Healthcare
40906174,413935,0,-7298579,2017-08-11,2017-08-11,Clothes
40906174,19129,0,-7317708,2017-08-12,2017-08-12,Transportation
40906174,17472,0,-7335180,2017-08-13,2017-08-13,Utilities
40906174,17191,0,-7352371,2017-08-14,2017-08-14,Education
40906174,0,15385,-7336986,2017-08-15,2017-08-15,
40906174,344875,0,-7681861,2017-08-15,2017-08-15,Utilities
40906174,0,331915,-7349946,2017-08-16,2017-08-16,
40906174,0,400831,-6949115,2017-08-16,2017-08-16,
40906174,301732,0,-7250847,2017-08-17,2017-08-17,Rent
40906174,493883,0,-7744730,2017-08-17,2017-08-17,Transportation
40906174,0,330863,-7413867,2017-08-18,2017-08-18,
40906174,401103,0,-7814970,2017-08-18,2017-08-18,Bill Sharing
40906174,0,413260,-7401710,2017-08-18,2017-08-18,
40906174,0,15330,-7386380,2017-08-19,2017-08-19,
40906174,444088,0,-7830468,2017-08-20,2017-08-20,Utilities
40906174,19165,0,-7849633,2017-08-21,2017-08-21,Rent
40906174,0,366734,-7482899,2017-08-21,2017-08-21,
40906174,18051,0,-7500950,2017-08-22,2017-08-22,Transportation
40906174,0,392579,-7108371,2017-08-23,2017-08-23,
40906174,11482,0,-7119853,2017-08-23,2017-08-23,Transportation
40906174,0,306857,-6812996,2017-08-24,2017-08-24,
40906174,370345,0,-7183341,2017-08-24,2017-08-24,Groceries
40906174,309982,0,-7493323,2017-08-25,2017-08-25,Education
40906174,351989,0,-7845312,2017-08-25,2017-08-25,Education
40906174,312910,0,-8158222,2017-08-25,2017-08-25,Rent
40906174,0,346820,-7811402,2017-08-26,2017-08-26,
40906174,0,16786,-7794616,2017-08-27,2017-08-27,
40906174,0,11711,-7782905,2017-08-27,2017-08-27,
40906174,482970,0,-8265875,2017-08-27,2017-08-27,Groceries
40906174,335184,0,-8601059,2017-08-28,2017-08-28,Rent
40906174,0,328387,-8272672,2017-08-28,2017-08-28,
40906174,381187,0,-8653859,2017-08-28,2017-08-28,Entertainment
40906174,0,407446,-8246413,2017-08-29,2017-08-29,
40906174,0,396191,-7850222,2017-08-30,2017-08-30,
40906174,0,17238,-7832984,2017-08-30,2017-08-30,
40906174,13295,0,-7846279,2017-08-31,2017-08-31,Utilities
40906174,0,323038,-7523241,2017-08-31,2017-08-31,
40906174,0,19259,-7503982,2017-09-01,2017-09-01,
40906174,493772,0,-7997754,2017-09-01,2017-09-01,Clothes
40906174,0,437304,-7560450,2017-09-02,2017-09-02,
40906174,0,16334,-7544116,2017-09-02,2017-09-02,
40906174,0,350079,-7194037,2017-09-02,2017-09-02,
40906174,0,352369,-6841668,2017-09-03,2017-09-03,
40906174,0,11458,-6830210,2017-09-04,2017-09-04,
40906174,0,633384,-6843910,2017-09-04,2017-09-04,
40906174,373798,0,-7217708,2017-09-05,2017-09-05,Groceries
40906174,0,490897,-6726811,2017-09-05,2017-09-05,
40906174,0,308668,-6418143,2017-09-05,2017-09-05,
40906174,0,10815,-6407328,2017-09-06,2017-09-06,
40906174,383846,0,-6791174,2017-09-06,2017-09-06,Utilities
40906174,0,393210,-6397964,2017-09-07,2017-09-07,
40906174,14464,0,-6412428,2017-09-07,2017-09-07,Bill Sharing
40906174,0,410962,-6001466,2017-09-07,2017-09-07,
40906174,0,486392,-5515074,2017-09-08,2017-09-08,
40906174,0,477783,-5037291,2017-09-08,2017-09-08,
40906174,321925,0,-5359216,2017-09-08,2017-09-08,Bill Sharing
40906174,0,318294,-5040922,2017-09-09,2017-09-09,
40906174,0,391289,-4649633,2017-09-10,2017-09-10,
40906174,479481,0,-5129114,2017-09-11,2017-09-11,Groceries
40906174,422749,0,-5551863,2017-09-11,2017-09-11,Utilities
40906174,531487,0,-5096627,2017-09-11,2017-09-11,Healthcare
40906174,0,10926,-5085701,2017-09-12,2017-09-12,
40906174,346303,0,-5432004,2017-09-12,2017-09-12,Bill Sharing
40906174,504650,0,-5911723,2017-09-12,2017-09-12,Education
40906174,401875,0,-6313598,2017-09-13,2017-09-13,Clothes
40906174,17469,0,-6331067,2017-09-13,2017-09-13,Entertainment
40906174,12785,0,-6343852,2017-09-14,2017-09-14,Clothes
40906174,19875,0,-6363727,2017-09-15,2017-09-15,Clothes
40906174,701666,0,-5913854,2017-09-15,2017-09-15,Education
40906174,357194,0,-6271048,2017-09-16,2017-09-16,Bill Sharing
40906174,17929,0,-6288977,2017-09-17,2017-09-17,Healthcare
40906174,0,12439,-6276538,2017-09-17,2017-09-17,
40906174,0,17954,-6258584,2017-09-18,2017-09-18,
40906174,0,13943,-6244641,2017-09-18,2017-09-18,
40906174,0,13406,-6231235,2017-09-18,2017-09-18,
40906174,17395,0,-6248630,2017-09-19,2017-09-19,Transportation
40906174,858330,0,-6268165,2017-09-19,2017-09-19,Education
40906174,19435,0,-6287600,2017-09-20,2017-09-20,Rent
40906174,0,499102,-5788498,2017-09-21,2017-09-21,
40906174,390640,0,-6179138,2017-09-22,2017-09-22,Healthcare
40906174,0,490618,-5688520,2017-09-23,2017-09-23,
40906174,0,17017,-5671503,2017-09-23,2017-09-23,
40906174,349668,0,-6021171,2017-09-23,2017-09-23,Groceries
40906174,682303,0,-5610142,2017-09-24,2017-09-24,Education
40906174,0,16043,-5594099,2017-09-24,2017-09-24,
40906174,0,13340,-5580759,2017-09-25,2017-09-25,
40906174,12444,0,-5593203,2017-09-26,2017-09-26,Bill Sharing
40906174,0,400428,-5192775,2017-09-27,2017-09-27,
40906174,0,15500,-5177275,2017-09-27,2017-09-27,
40906174,0,484014,-4693261,2017-09-27,2017-09-27,
40906174,0,18877,-4674384,2017-09-28,2017-09-28,
40906174,479200,0,-5153584,2017-09-29,2017-09-29,Clothes
40906174,0,488797,-4664787,2017-09-30,2017-09-30,
40906174,0,454893,-4209894,2017-09-30,2017-09-30,
40906174,0,17064,-4192830,2017-10-01,2017-10-01,
40906174,0,19706,-4173124,2017-10-01,2017-10-01,
40906174,13928,0,-4187052,2017-10-01,2017-10-01,Rent
40906174,402174,0,-4589226,2017-10-02,2017-10-02,Education
40906174,0,499328,-4089898,2017-10-02,2017-10-02,
40906174,486483,0,-4576381,2017-10-02,2017-10-02,Bill Sharing
40906174,380114,0,-4956495,2017-10-03,2017-10-03,Bill Sharing
40906174,0,10988,-4945507,2017-10-04,2017-10-04,
40906174,344307,0,-5289814,2017-10-05,2017-10-05,Groceries
40906174,0,434241,-4855573,2017-10-05,2017-10-05,
40906174,13205,0,-4868778,2017-10-05,2017-10-05,Healthcare
40906174,0,17607,-4851171,2017-10-06,2017-10-06,
40906174,0,308047,-4543124,2017-10-07,2017-10-07,
40906174,12206,0,-4555330,2017-10-08,2017-10-08,Entertainment
40906174,0,362804,-4192526,2017-10-08,2017-10-08,
40906174,11708,0,-4204234,2017-10-09,2017-10-09,Transportation
40906174,0,345328,-3858906,2017-10-09,2017-10-09,
40906174,0,463412,-3395494,2017-10-10,2017-10-10,
40906174,0,484726,-2910768,2017-10-11,2017-10-11,
40906174,0,325583,-2585185,2017-10-11,2017-10-11,
40906174,414344,0,-2999529,2017-10-11,2017-10-11,Bill Sharing
40906174,0,490146,-2509383,2017-10-12,2017-10-12,
40906174,669532,0,-2494352,2017-10-13,2017-10-13,Healthcare
40906174,0,15272,-2479080,2017-10-13,2017-10-13,
40906174,14106,0,-2493186,2017-10-14,2017-10-14,Bill Sharing
40906174,15716,0,-2508902,2017-10-14,2017-10-14,Entertainment
40906174,0,10756,-2498146,2017-10-14,2017-10-14,
40906174,17782,0,-2515928,2017-10-15,2017-10-15,Bill Sharing
40906174,18183,0,-2534111,2017-10-15,2017-10-15,Healthcare
40906174,0,303716,-2230395,2017-10-15,2017-10-15,
40906174,0,436144,-1794251,2017-10-16,2017-10-16,
40906174,0,11147,-1783104,2017-10-17,2017-10-17,
40906174,0,320384,-1462720,2017-10-17,2017-10-17,
40906174,0,18451,-1444269,2017-10-18,2017-10-18,
40906174,869549,0,-1460927,2017-10-18,2017-10-18,Education
40906174,0,14863,-1446064,2017-10-19,2017-10-19,
40906174,450684,0,-1896748,2017-10-19,2017-10-19,Bill Sharing
40906174,0,15826,-1880922,2017-10-20,2017-10-20,
40906174,495696,0,-2376618,2017-10-20,2017-10-20,Education
40906174,499972,0,-2876590,2017-10-20,2017-10-20,Utilities
40906174,414463,0,-3291053,2017-10-21,2017-10-21,Education
40906174,0,10634,-3280419,2017-10-22,2017-10-22,
40906174,938215,0,-2948129,2017-10-22,2017-10-22,Healthcare
40906174,457686,0,-3405815,2017-10-23,2017-10-23,Clothes
40906174,365262,0,-3771077,2017-10-23,2017-10-23,Education
40906174,386895,0,-4157972,2017-10-24,2017-10-24,Groceries
40906174,0,16076,-4141896,2017-10-24,2017-10-24,
40906174,315509,0,-4457405,2017-10-25,2017-10-25,Education
40906174,423939,0,-4881344,2017-10-26,2017-10-26,Education
40906174,0,10028,-4871316,2017-10-26,2017-10-26,
40906174,371996,0,-5243312,2017-10-26,2017-10-26,Bill Sharing
40906174,10168,0,-5253480,2017-10-27,2017-10-27,Bill Sharing
40906174,0,349973,-4903507,2017-10-27,2017-10-27,
40906174,0,14680,-4888827,2017-10-28,2017-10-28,
40906174,387501,0,-5276328,2017-10-28,2017-10-28,Transportation
40906174,0,393834,-4882494,2017-10-28,2017-10-28,
40906174,371994,0,-5254488,2017-10-29,2017-10-29,Healthcare
40906174,0,340493,-4913995,2017-10-29,2017-10-29,
40906174,0,410830,-4503165,2017-10-29,2017-10-29,
40906174,14093,0,-4517258,2017-10-30,2017-10-30,Entertainment
40906174,14659,0,-4531917,2017-10-30,2017-10-30,Transportation
40906174,10804,0,-4542721,2017-10-30,2017-10-30,Groceries
40906174,483145,0,-5025866,2017-10-31,2017-10-31,Education
40906174,461485,0,-5487351,2017-10-31,2017-10-31,Transportation
40906174,0,338119,-5149232,2017-10-31,2017-10-31,
40906174,0,15803,-5133429,2017-11-01,2017-11-01,
40906174,300335,0,-5433764,2017-11-01,2017-11-01,Healthcare
40906174,0,16621,-5417143,2017-11-01,2017-11-01,
40906174,0,12893,-5404250,2017-11-02,2017-11-02,
40906174,771431,0,-5423093,2017-11-03,2017-11-03,Education
40906174,405936,0,-5829029,2017-11-04,2017-11-04,Groceries
40906174,498139,0,-6327168,2017-11-04,2017-11-04,Groceries
40906174,398964,0,-6726132,2017-11-05,2017-11-05,Utilities
40906174,0,15079,-6711053,2017-11-05,2017-11-05,
40906174,14917,0,-6725970,2017-11-05,2017-11-05,Bill Sharing
40906174,0,382787,-6343183,2017-11-06,2017-11-06,
40906174,0,347003,-5996180,2017-11-07,2017-11-07,
40906174,18303,0,-6014483,2017-11-07,2017-11-07,Healthcare
40906174,0,340428,-5674055,2017-11-07,2017-11-07,
40906174,0,379354,-5294701,2017-11-08,2017-11-08,
40906174,0,17710,-5276991,2017-11-08,2017-11-08,
40906174,320246,0,-5597237,2017-11-09,2017-11-09,Clothes
40906174,0,453719,-5143518,2017-11-09,2017-11-09,
40906174,0,301026,-4842492,2017-11-10,2017-11-10,
40906174,0,19679,-4822813,2017-11-10,2017-11-10,
40906174,11075,0,-4833888,2017-11-10,2017-11-10,Bill Sharing
40906174,0,480708,-4823252,2017-11-11,2017-11-11,
40906174,0,343458,-4479794,2017-11-11,2017-11-11,
40906174,365502,0,-4845296,2017-11-12,2017-11-12,Utilities
40906174,338554,0,-5183850,2017-11-13,2017-11-13,Entertainment
40906174,401999,0,-5585849,2017-11-13,2017-11-13,Education
40906174,0,434579,-5151270,2017-11-13,2017-11-13,
40906174,0,14330,-5136940,2017-11-14,2017-11-14,
40906174,0,19443,-5117497,2017-11-14,2017-11-14,
40906174,342161,0,-5459658,2017-11-15,2017-11-15,Groceries
40906174,0,345669,-5113989,2017-11-15,2017-11-15,
40906174,0,18430,-5095559,2017-11-16,2017-11-16,
40906174,14552,0,-5110111,2017-11-17,2017-11-17,Transportation
40906174,15892,0,-5126003,2017-11-17,2017-11-17,Entertainment
40906174,0,497960,-4628043,2017-11-17,2017-11-17,
40906174,0,493459,-4134584,2017-11-18,2017-11-18,
40906174,421550,0,-4556134,2017-11-19,2017-11-19,Groceries
40906174,0,398403,-4157731,2017-11-19,2017-11-19,
40906174,0,478280,-4516998,2017-11-19,2017-11-19,
40906174,12507,0,-4529505,2017-11-20,2017-11-20,Entertainment
40906174,16882,0,-4546387,2017-11-21,2017-11-21,Clothes
40906174,0,14396,-4531991,2017-11-21,2017-11-21,
40906174,0,466251,-4549937,2017-11-22,2017-11-22,
40906174,15049,0,-4564986,2017-11-22,2017-11-22,Education
40906174,474533,0,-5039519,2017-11-23,2017-11-23,Education
40906174,434426,0,-5473945,2017-11-24,2017-11-24,Entertainment
40906174,0,16553,-5457392,2017-11-24,2017-11-24,
40906174,0,906646,-5437756,2017-11-25,2017-11-25,
40906174,0,10786,-5426970,2017-11-25,2017-11-25,
40906174,10765,0,-5437735,2017-11-25,2017-11-25,Healthcare
40906174,0,307359,-5130376,2017-11-26,2017-11-26,
40906174,380964,0,-5511340,2017-11-27,2017-11-27,Bill Sharing
40906174,0,19085,-5492255,2017-11-28,2017-11-28,
40906174,440433,0,-5932688,2017-11-28,2017-11-28,Transportation
40906174,371369,0,-6304057,2017-11-29,2017-11-29,Rent
40906174,0,340825,-5963232,2017-11-29,2017-11-29,
40906174,12334,0,-5975566,2017-11-30,2017-11-30,Transportation
40906174,0,399774,-5575792,2017-11-30,2017-11-30,
40906174,0,386532,-5189260,2017-12-01,2017-12-01,
40906174,0,452382,-4736878,2017-12-02,2017-12-02,
40906174,19774,0,-4756652,2017-12-02,2017-12-02,Bill Sharing
40906174,0,11057,-4745595,2017-12-03,2017-12-03,
40906174,10681,0,-4756276,2017-12-03,2017-12-03,Rent
40906174,460087,0,-5216363,2017-12-03,2017-12-03,Transportation
40906174,0,491865,-4724498,2017-12-04,2017-12-04,
40906174,0,15642,-4708856,2017-12-05,2017-12-05,
40906174,12383,0,-4721239,2017-12-06,2017-12-06,Healthcare
40906174,0,434469,-4286770,2017-12-06,2017-12-06,
40906174,17223,0,-4303993,2017-12-07,2017-12-07,Groceries
40906174,10575,0,-4314568,2017-12-07,2017-12-07,Bill Sharing
40906174,558539,0,-3866515,2017-12-08,2017-12-08,Education
40906174,324218,0,-4190733,2017-12-09,2017-12-09,Education
40906174,475072,0,-4665805,2017-12-09,2017-12-09,Entertainment
40906174,0,18038,-4647767,2017-12-09,2017-12-09,
40906174,0,325404,-4322363,2017-12-10,2017-12-10,
40906174,0,363933,-3958430,2017-12-10,2017-12-10,
40906174,0,13444,-3944986,2017-12-10,2017-12-10,
40906174,0,385666,-3559320,2017-12-11,2017-12-11,
40906174,0,458112,-3101208,2017-12-12,2017-12-12,
40906174,0,16086,-3085122,2017-12-12,2017-12-12,
40906174,0,13904,-3071218,2017-12-12,2017-12-12,
40906174,732696,0,-2585044,2017-12-13,2017-12-13,Education
40906174,0,15563,-2569481,2017-12-13,2017-12-13,
40906174,0,17534,-2551947,2017-12-13,2017-12-13,
40906174,0,497929,-2066235,2017-12-14,2017-12-14,
40906174,0,10956,-2055279,2017-12-14,2017-12-14,
40906174,0,14057,-2041222,2017-12-14,2017-12-14,
40906174,0,481268,-1559954,2017-12-15,2017-12-15,
40906174,14709,0,-1574663,2017-12-16,2017-12-16,Entertainment
40906174,326867,0,-1901530,2017-12-17,2017-12-17,Groceries
40906174,492251,0,-2393781,2017-12-17,2017-12-17,Entertainment
40906174,356667,0,-2750448,2017-12-18,2017-12-18,Entertainment
40906174,14411,0,-2764859,2017-12-18,2017-12-18,Clothes
40906174,0,349837,-2415022,2017-12-18,2017-12-18,
40906174,0,12909,-2402113,2017-12-19,2017-12-19,
40906174,456910,0,-2859023,2017-12-20,2017-12-20,Entertainment
40906174,422096,0,-3281119,2017-12-20,2017-12-20,Bill Sharing
40906174,0,438023,-2843096,2017-12-21,2017-12-21,
40906174,19946,0,-2863042,2017-12-21,2017-12-21,Healthcare
40906174,14660,0,-2877702,2017-12-22,2017-12-22,Entertainment
40906174,11849,0,-2889551,2017-12-22,2017-12-22,Entertainment
40906174,0,346235,-2543316,2017-12-23,2017-12-23,
40906174,305136,0,-2848452,2017-12-24,2017-12-24,Healthcare
40906174,0,432911,-2415541,2017-12-24,2017-12-24,
40906174,0,438784,-2870995,2017-12-24,2017-12-24,
40906174,0,377876,-2493119,2017-12-25,2017-12-25,
40906174,0,11829,-2481290,2017-12-25,2017-12-25,
40906174,873006,0,-2495663,2017-12-26,2017-12-26,Education
40906174,0,349534,-2146129,2017-12-27,2017-12-27,
40906174,0,12199,-2133930,2017-12-27,2017-12-27,
40906174,0,494231,-1639699,2017-12-27,2017-12-27,
40906174,369733,0,-2009432,2017-12-28,2017-12-28,Healthcare
40906174,10606,0,-2020038,2017-12-28,2017-12-28,Groceries
40906174,0,15240,-2004798,2017-12-29,2017-12-29,
40906174,0,384451,-1620347,2017-12-29,2017-12-29,
40906174,387363,0,-2007710,2017-12-30,2017-12-30,Healthcare
40906174,0,347549,-1660161,2017-12-31,2017-12-31,
40906174,0,383338,-1276823,2017-12-31,2017-12-31,
40906174,0,301002,-975821,2018-01-01,2018-01-01,
40906174,16726,0,-992547,2018-01-01,2018-01-01,Bill Sharing
40906174,417489,0,-1410036,2018-01-01,2018-01-01,Groceries
40906174,0,427877,-982159,2018-01-02,2018-01-02,
40906174,424670,0,-1406829,2018-01-02,2018-01-02,Transportation
40906174,18695,0,-1425524,2018-01-03,2018-01-03,Entertainment
40906174,338096,0,-1763620,2018-01-03,2018-01-03,Rent
40906174,0,17987,-1745633,2018-01-04,2018-01-04,
40906174,0,444780,-1300853,2018-01-05,2018-01-05,
40906174,0,19990,-1280863,2018-01-05,2018-01-05,
40906174,486670,0,-1767533,2018-01-05,2018-01-05,Entertainment
40906174,0,11834,-1755699,2018-01-06,2018-01-06,
40906174,0,472914,-1282785,2018-01-06,2018-01-06,
40906174,347044,0,-1629829,2018-01-07,2018-01-07,Rent
40906174,0,17182,-1612647,2018-01-07,2018-01-07,
40906174,484931,0,-2097578,2018-01-07,2018-01-07,Entertainment
40906174,0,462649,-1634929,2018-01-08,2018-01-08,
40906174,450578,0,-2085507,2018-01-09,2018-01-09,Clothes
40906174,457886,0,-2543393,2018-01-10,2018-01-10,Rent
40906174,0,392743,-2150650,2018-01-11,2018-01-11,
40906174,0,421660,-1728990,2018-01-11,2018-01-11,
40906174,0,337058,-1391932,2018-01-12,2018-01-12,
40906174,0,458252,-933680,2018-01-13,2018-01-13,
40906174,417882,0,-1351562,2018-01-13,2018-01-13,Education
40906174,333477,0,-1685039,2018-01-14,2018-01-14,Transportation
40906174,0,486794,-1198245,2018-01-15,2018-01-15,
40906174,0,495183,-703062,2018-01-15,2018-01-15,
40906174,0,467242,-235820,2018-01-16,2018-01-16,
40906174,0,483720,247900,2018-01-16,2018-01-16,
40906174,0,14610,262510,2018-01-16,2018-01-16,
40906174,0,328390,590900,2018-01-17,2018-01-17,
40906174,0,332313,923213,2018-01-17,2018-01-17,
40906174,0,13291,-936504,2018-01-18,2018-01-18,
40906174,888662,0,-542338,2018-01-18,2018-01-18,Education
40906174,0,14559,-527779,2018-01-18,2018-01-18,
40906174,0,392103,-135676,2018-01-19,2018-01-19,
40906174,16473,0,-152149,2018-01-20,2018-01-20,Healthcare
40906174,482254,0,-634403,2018-01-21,2018-01-21,Clothes
40906174,0,358317,-276086,2018-01-21,2018-01-21,
40906174,457746,0,-733832,2018-01-21,2018-01-21,Entertainment
40906174,451412,0,-1185244,2018-01-22,2018-01-22,Bill Sharing
40906174,0,10984,-1174260,2018-01-23,2018-01-23,
40906174,0,17589,-1156671,2018-01-24,2018-01-24,
40906174,0,466265,-690406,2018-01-25,2018-01-25,
40906174,335063,0,-1025469,2018-01-25,2018-01-25,Education
40906174,745294,0,-1517123,2018-01-26,2018-01-26,Healthcare
40906174,374773,0,-1891896,2018-01-26,2018-01-26,Utilities
40906174,16822,0,-1908718,2018-01-26,2018-01-26,Education
40906174,423423,0,-2332141,2018-01-27,2018-01-27,Clothes
40906174,344184,0,-2676325,2018-01-27,2018-01-27,Transportation
40906174,0,11662,-2664663,2018-01-27,2018-01-27,
40906174,0,480399,-2184264,2018-01-28,2018-01-28,
40906174,0,401455,-1782809,2018-01-29,2018-01-29,
40906174,409093,0,-2191902,2018-01-29,2018-01-29,Education
40906174,11195,0,-2203097,2018-01-29,2018-01-29,Entertainment
40906174,0,328025,-1875072,2018-01-30,2018-01-30,
40906174,17631,0,-1892703,2018-01-30,2018-01-30,Clothes
40906174,0,979402,-1872975,2018-01-30,2018-01-30,
40906174,0,439033,-1433942,2018-01-31,2018-01-31,
40906174,10743,0,-1444685,2018-01-31,2018-01-31,Groceries
40906174,0,332075,-1112610,2018-02-01,2018-02-01,
40906174,0,416115,-696495,2018-02-02,2018-02-02,
40906174,312835,0,-1009330,2018-02-03,2018-02-03,Entertainment
40906174,0,497170,-512160,2018-02-03,2018-02-03,
40906174,304432,0,-816592,2018-02-03,2018-02-03,Utilities
40906174,0,16616,-799976,2018-02-04,2018-02-04,
40906174,414601,0,-1214577,2018-02-05,2018-02-05,Education
40906174,0,399253,-815324,2018-02-05,2018-02-05,
40906174,0,18933,-796391,2018-02-05,2018-02-05,
40906174,19219,0,-815610,2018-02-06,2018-02-06,Healthcare
40906174,0,16880,-798730,2018-02-06,2018-02-06,
40906174,482758,0,-1281488,2018-02-06,2018-02-06,Transportation
40906174,10697,0,-1292185,2018-02-07,2018-02-07,Groceries
40906174,0,13808,-1278377,2018-02-07,2018-02-07,
40906174,497385,0,-1775762,2018-02-07,2018-02-07,Groceries
40906174,0,440801,-1334961,2018-02-08,2018-02-08,
40906174,0,457004,-877957,2018-02-08,2018-02-08,
40906174,424197,0,-1302154,2018-02-08,2018-02-08,Groceries
40906174,0,493299,-808855,2018-02-09,2018-02-09,
40906174,0,554433,-1197928,2018-02-09,2018-02-09,
40906174,10897,0,-1208825,2018-02-10,2018-02-10,Education
40906174,0,18536,-1190289,2018-02-10,2018-02-10,
40906174,0,427136,-763153,2018-02-10,2018-02-10,
40906174,0,306782,-456371,2018-02-11,2018-02-11,
40906174,18787,0,-475158,2018-02-12,2018-02-12,Entertainment
40906174,0,409661,-65497,2018-02-13,2018-02-13,
40906174,13799,0,-79296,2018-02-13,2018-02-13,Clothes
40906174,17557,0,-96853,2018-02-14,2018-02-14,Utilities
40906174,17775,0,-114628,2018-02-14,2018-02-14,Entertainment
40906174,481560,0,-596188,2018-02-15,2018-02-15,Rent
40906174,306994,0,-903182,2018-02-15,2018-02-15,Rent
40906174,0,14242,-888940,2018-02-16,2018-02-16,
40906174,0,19585,-869355,2018-02-17,2018-02-17,
40906174,0,18261,-851094,2018-02-17,2018-02-17,
40906174,0,455104,-395990,2018-02-17,2018-02-17,
40906174,13145,0,-409135,2018-02-18,2018-02-18,Entertainment
40906174,0,312978,-96157,2018-02-19,2018-02-19,
40906174,0,495957,399800,2018-02-19,2018-02-19,
40906174,0,322779,-722579,2018-02-19,2018-02-19,
40906174,492574,0,-1215153,2018-02-20,2018-02-20,Utilities
40906174,11895,0,-1227048,2018-02-20,2018-02-20,Utilities
40906174,10753,0,-1237801,2018-02-21,2018-02-21,Rent
40906174,453567,0,-1691368,2018-02-21,2018-02-21,Clothes
40906174,0,394225,-1297143,2018-02-21,2018-02-21,
40906174,0,12362,-1284781,2018-02-22,2018-02-22,
40906174,0,339558,-945223,2018-02-22,2018-02-22,
40906174,0,409252,-535971,2018-02-23,2018-02-23,
40906174,16574,0,-552545,2018-02-23,2018-02-23,Entertainment
40906174,488042,0,-1040587,2018-02-24,2018-02-24,Rent
40906174,10127,0,-1050714,2018-02-25,2018-02-25,Clothes
40906174,0,11202,-1039512,2018-02-26,2018-02-26,
40906174,415948,0,-1455460,2018-02-26,2018-02-26,Utilities
40906174,0,10032,-1445428,2018-02-26,2018-02-26,
40906174,319163,0,-1764591,2018-02-27,2018-02-27,Education
40906174,0,10200,-1754391,2018-02-27,2018-02-27,
40906174,0,496310,-1258081,2018-02-28,2018-02-28,
40906174,15158,0,-1273239,2018-03-01,2018-03-01,Entertainment
40906174,482586,0,-1755825,2018-03-02,2018-03-02,Groceries
40906174,460981,0,-2216806,2018-03-02,2018-03-02,Healthcare
40906174,0,490897,-1725909,2018-03-03,2018-03-03,
40906174,0,468415,-1257494,2018-03-03,2018-03-03,
40906174,0,352504,-904990,2018-03-04,2018-03-04,
40906174,420163,0,-1325153,2018-03-05,2018-03-05,Education
40906174,374988,0,-1700141,2018-03-06,2018-03-06,Transportation
40906174,0,478511,-1221630,2018-03-06,2018-03-06,
40906174,0,418258,-803372,2018-03-07,2018-03-07,
40906174,14698,0,-818070,2018-03-07,2018-03-07,Clothes
40906174,0,397561,-420509,2018-03-08,2018-03-08,
40906174,0,413386,-7123,2018-03-08,2018-03-08,
40906174,415214,0,-422337,2018-03-08,2018-03-08,Transportation
40906174,0,410714,-11623,2018-03-09,2018-03-09,
40906174,0,12129,506,2018-03-09,2018-03-09,
40906174,15447,0,-14941,2018-03-10,2018-03-10,Bill Sharing
40906174,423679,0,-438620,2018-03-10,2018-03-10,Entertainment
40906174,0,308317,-130303,2018-03-10,2018-03-10,
40906174,0,12627,-117676,2018-03-11,2018-03-11,
40906174,0,16537,-101139,2018-03-12,2018-03-12,
40906174,437161,0,-538300,2018-03-13,2018-03-13,Bill Sharing
40906174,314684,0,-852984,2018-03-13,2018-03-13,Groceries
40906174,0,331408,-521576,2018-03-14,2018-03-14,
40906174,16927,0,-538503,2018-03-15,2018-03-15,Bill Sharing
40906174,488333,0,-1026836,2018-03-16,2018-03-16,Healthcare
40906174,341224,0,-1368060,2018-03-17,2018-03-17,Bill Sharing
40906174,0,423679,-944381,2018-03-18,2018-03-18,
40906174,19174,0,-963555,2018-03-18,2018-03-18,Healthcare
40906174,459434,0,-1422989,2018-03-18,2018-03-18,Education
40906174,376108,0,-1799097,2018-03-19,2018-03-19,Groceries
40906174,628405,0,-1434292,2018-03-19,2018-03-19,Education
40906174,0,339441,-1094851,2018-03-19,2018-03-19,
40906174,420829,0,-1515680,2018-03-20,2018-03-20,Entertainment
40906174,0,417918,-1097762,2018-03-20,2018-03-20,
40906174,0,19148,-1078614,2018-03-21,2018-03-21,
40906174,0,476157,-602457,2018-03-22,2018-03-22,
40906174,486308,0,-1088765,2018-03-23,2018-03-23,Groceries
40906174,16933,0,-1105698,2018-03-23,2018-03-23,Education
40906174,338955,0,-1444653,2018-03-23,2018-03-23,Rent
40906174,0,425393,-1019260,2018-03-24,2018-03-24,
40906174,382111,0,-1401371,2018-03-24,2018-03-24,Rent
40906174,314137,0,-1715508,2018-03-25,2018-03-25,Groceries
40906174,13154,0,-1728662,2018-03-25,2018-03-25,Transportation
40906174,371572,0,-2100234,2018-03-25,2018-03-25,Education
40906174,0,394505,-1705729,2018-03-26,2018-03-26,
40906174,430348,0,-2136077,2018-03-26,2018-03-26,Education
40906174,790445,0,-2495205,2018-03-26,2018-03-26,Education
40906174,0,379865,-2115340,2018-03-27,2018-03-27,
40906174,0,14947,-2100393,2018-03-28,2018-03-28,
40906174,0,434101,-1666292,2018-03-28,2018-03-28,
40906174,0,340257,-1326035,2018-03-28,2018-03-28,
40906174,19106,0,-1345141,2018-03-29,2018-03-29,Utilities
40906174,0,352823,-992318,2018-03-29,2018-03-29,
40906174,370868,0,-1363186,2018-03-29,2018-03-29,Rent
40906174,0,19471,-1343715,2018-03-30,2018-03-30,
40906174,16269,0,-1359984,2018-03-30,2018-03-30,Bill Sharing
40906174,0,418373,-941611,2018-03-31,2018-03-31,
40906174,399479,0,-1341090,2018-03-31,2018-03-31,Utilities
40906174,19173,0,-1360263,2018-03-31,2018-03-31,Entertainment
40906174,0,482247,-878016,2018-04-01,2018-04-01,
40906174,0,11625,-866391,2018-04-01,2018-04-01,
40906174,14577,0,-880968,2018-04-01,2018-04-01,Transportation
40906174,0,490208,-390760,2018-04-02,2018-04-02,
40906174,489958,0,-880718,2018-04-02,2018-04-02,Rent
40906174,0,333974,-546744,2018-04-02,2018-04-02,
40906174,11757,0,-558501,2018-04-03,2018-04-03,Bill Sharing
40906174,12457,0,-570958,2018-04-04,2018-04-04,Rent
40906174,400044,0,-971002,2018-04-04,2018-04-04,Bill Sharing
40906174,0,481054,-489948,2018-04-04,2018-04-04,
40906174,0,11792,-478156,2018-04-05,2018-04-05,
40906174,483243,0,-961399,2018-04-06,2018-04-06,Bill Sharing
40906174,0,16941,-944458,2018-04-06,2018-04-06,
40906174,378146,0,-1322604,2018-04-06,2018-04-06,Healthcare
40906174,0,893884,-1310453,2018-04-07,2018-04-07,
40906174,14395,0,-1324848,2018-04-07,2018-04-07,Education
40906174,617743,0,-1335032,2018-04-08,2018-04-08,Healthcare
40906174,0,13963,-1321069,2018-04-08,2018-04-08,
40906174,0,13973,-1307096,2018-04-08,2018-04-08,
40906174,13555,0,-1320651,2018-04-09,2018-04-09,Bill Sharing
40906174,0,17400,-1303251,2018-04-09,2018-04-09,
40906174,0,12514,-1290737,2018-04-10,2018-04-10,
40906174,351066,0,-1641803,2018-04-10,2018-04-10,Bill Sharing
40906174,319500,0,-1961303,2018-04-10,2018-04-10,Utilities
40906174,0,19574,-1941729,2018-04-11,2018-04-11,
40906174,402105,0,-2343834,2018-04-12,2018-04-12,Utilities
40906174,0,15035,-2328799,2018-04-13,2018-04-13,
40906174,0,12607,-2316192,2018-04-14,2018-04-14,
40906174,0,12510,-2303682,2018-04-15,2018-04-15,
40906174,400014,0,-2703696,2018-04-15,2018-04-15,Healthcare
40906174,0,15356,-2688340,2018-04-15,2018-04-15,
40906174,0,16045,-2672295,2018-04-16,2018-04-16,
40906174,0,394485,-2277810,2018-04-17,2018-04-17,
40906174,482068,0,-2759878,2018-04-18,2018-04-18,Bill Sharing
40906174,0,15277,-2744601,2018-04-19,2018-04-19,
40906174,0,315237,-2429364,2018-04-20,2018-04-20,
40906174,18756,0,-2448120,2018-04-21,2018-04-21,Education
40906174,445387,0,-2893507,2018-04-22,2018-04-22,Rent
40906174,0,311575,-2581932,2018-04-22,2018-04-22,
40906174,744261,0,-2926079,2018-04-22,2018-04-22,Education
40906174,0,16026,-2910053,2018-04-23,2018-04-23,
40906174,0,343848,-2566205,2018-04-23,2018-04-23,
40906174,0,434976,-2131229,2018-04-24,2018-04-24,
40906174,0,371021,-1760208,2018-04-25,2018-04-25,
40906174,517453,0,-1342263,2018-04-25,2018-04-25,Education
40906174,12368,0,-1354631,2018-04-25,2018-04-25,Entertainment
40906174,429987,0,-1784618,2018-04-26,2018-04-26,Entertainment
40906174,448763,0,-2233381,2018-04-27,2018-04-27,Healthcare
40906174,0,11874,-2221507,2018-04-27,2018-04-27,
40906174,0,368824,-1852683,2018-04-28,2018-04-28,
40906174,0,11507,-1841176,2018-04-28,2018-04-28,
40906174,451632,0,-2292808,2018-04-28,2018-04-28,Education
40906174,17318,0,-2310126,2018-04-29,2018-04-29,Bill Sharing
40906174,308008,0,-2618134,2018-04-29,2018-04-29,Clothes
40906174,14077,0,-2632211,2018-04-29,2018-04-29,Healthcare
40906174,445870,0,-3078081,2018-04-30,2018-04-30,Entertainment
40906174,0,12375,-3065706,2018-04-30,2018-04-30,
40906174,0,13855,-3051851,2018-05-01,2018-05-01,
40906174,354003,0,-3405854,2018-05-01,2018-05-01,Clothes
40906174,0,520451,-3863657,2018-05-02,2018-05-02,
40906174,0,458493,-3405164,2018-05-02,2018-05-02,
40906174,12958,0,-3418122,2018-05-03,2018-05-03,Bill Sharing
40906174,0,484959,-2933163,2018-05-04,2018-05-04,
40906174,18539,0,-2951702,2018-05-04,2018-05-04,Utilities
40906174,0,956878,-3291796,2018-05-05,2018-05-05,
40906174,348233,0,-3640029,2018-05-05,2018-05-05,Entertainment
40906174,303562,0,-3943591,2018-05-05,2018-05-05,Bill Sharing
40906174,0,319165,-3624426,2018-05-06,2018-05-06,
40906174,0,457444,-3166982,2018-05-06,2018-05-06,
40906174,0,13624,-3153358,2018-05-06,2018-05-06,
40906174,0,14361,-3138997,2018-05-07,2018-05-07,
40906174,15575,0,-3154572,2018-05-07,2018-05-07,Clothes
40906174,468911,0,-3623483,2018-05-07,2018-05-07,Utilities
40906174,0,426033,-3197450,2018-05-08,2018-05-08,
40906174,0,12537,-3184913,2018-05-09,2018-05-09,
40906174,0,354515,-2830398,2018-05-09,2018-05-09,
40906174,465080,0,-3295478,2018-05-09,2018-05-09,Clothes
40906174,0,365668,-2929810,2018-05-10,2018-05-10,
40906174,0,473142,-2456668,2018-05-10,2018-05-10,
40906174,0,470116,-1986552,2018-05-10,2018-05-10,
40906174,0,13948,-1972604,2018-05-11,2018-05-11,
40906174,16018,0,-1988622,2018-05-12,2018-05-12,Groceries
40906174,0,974641,-1514502,2018-05-12,2018-05-12,
40906174,0,429149,-1085353,2018-05-13,2018-05-13,
40906174,0,12640,-1072713,2018-05-14,2018-05-14,
40906174,0,16190,-1056523,2018-05-14,2018-05-14,
40906174,0,331708,-724815,2018-05-15,2018-05-15,
40906174,0,494102,-230713,2018-05-15,2018-05-15,
40906174,545201,0,-215232,2018-05-15,2018-05-15,Education
40906174,0,498732,283500,2018-05-16,2018-05-16,
40906174,318548,0,-35048,2018-05-16,2018-05-16,Entertainment
40906174,457203,0,-492251,2018-05-16,2018-05-16,Groceries
40906174,370711,0,-862962,2018-05-17,2018-05-17,Transportation
40906174,0,593292,-847690,2018-05-18,2018-05-18,
40906174,354786,0,-1202476,2018-05-19,2018-05-19,Groceries
40906174,18496,0,-1220972,2018-05-19,2018-05-19,Entertainment
40906174,0,404933,-816039,2018-05-20,2018-05-20,
40906174,340072,0,-1156111,2018-05-20,2018-05-20,Healthcare
40906174,486019,0,-1642130,2018-05-21,2018-05-21,Transportation
40906174,13767,0,-1655897,2018-05-21,2018-05-21,Healthcare
40906174,413847,0,-2069744,2018-05-22,2018-05-22,Groceries
40906174,317881,0,-2387625,2018-05-22,2018-05-22,Utilities
40906174,19276,0,-2406901,2018-05-23,2018-05-23,Utilities
40906174,0,18288,-2388613,2018-05-23,2018-05-23,
40906174,356041,0,-2744654,2018-05-24,2018-05-24,Clothes
40906174,381707,0,-3126361,2018-05-24,2018-05-24,Clothes
40906174,0,10782,-3115579,2018-05-25,2018-05-25,
40906174,0,11180,-3104399,2018-05-25,2018-05-25,
40906174,0,310113,-2794286,2018-05-26,2018-05-26,
40906174,412525,0,-3206811,2018-05-26,2018-05-26,Rent
40906174,0,11633,-3195178,2018-05-27,2018-05-27,
40906174,397431,0,-3592609,2018-05-28,2018-05-28,Bill Sharing
40906174,0,421190,-3171419,2018-05-28,2018-05-28,
40906174,0,306406,-2865013,2018-05-28,2018-05-28,
40906174,0,19081,-2845932,2018-05-29,2018-05-29,
40906174,393324,0,-3239256,2018-05-29,2018-05-29,Bill Sharing
40906174,486261,0,-3725517,2018-05-30,2018-05-30,Rent
40906174,415482,0,-4140999,2018-05-30,2018-05-30,Healthcare
40906174,15869,0,-4156868,2018-05-30,2018-05-30,Groceries
40906174,0,366068,-3790800,2018-05-31,2018-05-31,
40906174,0,407591,-3383209,2018-06-01,2018-06-01,
40906174,0,12161,-3371048,2018-06-01,2018-06-01,
40906174,394360,0,-3765408,2018-06-01,2018-06-01,Utilities
40906174,332014,0,-4097422,2018-06-02,2018-06-02,Bill Sharing
40906174,358946,0,-4456368,2018-06-02,2018-06-02,Clothes
40906174,16707,0,-4473075,2018-06-02,2018-06-02,Bill Sharing
40906174,334540,0,-4807615,2018-06-03,2018-06-03,Education
40906174,352448,0,-5160063,2018-06-03,2018-06-03,Rent
40906174,0,449142,-4710921,2018-06-04,2018-06-04,
40906174,350031,0,-5060952,2018-06-04,2018-06-04,Groceries
40906174,438494,0,-5499446,2018-06-05,2018-06-05,Entertainment
40906174,11546,0,-5510992,2018-06-06,2018-06-06,Bill Sharing
40906174,0,491025,-5019967,2018-06-07,2018-06-07,
40906174,0,393718,-4626249,2018-06-07,2018-06-07,
40906174,0,395204,-4231045,2018-06-07,2018-06-07,
40906174,0,377441,-3853604,2018-06-08,2018-06-08,
40906174,15549,0,-3869153,2018-06-08,2018-06-08,Education
40906174,0,17747,-3851406,2018-06-08,2018-06-08,
40906174,0,311879,-3539527,2018-06-09,2018-06-09,
40906174,0,13701,-3525826,2018-06-09,2018-06-09,
40906174,0,387502,-3138324,2018-06-10,2018-06-10,
40906174,13407,0,-3151731,2018-06-10,2018-06-10,Clothes
40906174,362642,0,-3514373,2018-06-10,2018-06-10,Entertainment
40906174,925839,0,-3157258,2018-06-11,2018-06-11,Education
40906174,344728,0,-3501986,2018-06-12,2018-06-12,Clothes
40906174,18438,0,-3520424,2018-06-13,2018-06-13,Entertainment
40906174,18892,0,-3539316,2018-06-13,2018-06-13,Rent
40906174,342276,0,-3881592,2018-06-13,2018-06-13,Transportation
40906174,443513,0,-4325105,2018-06-14,2018-06-14,Transportation
40906174,0,385075,-3940030,2018-06-15,2018-06-15,
40906174,14765,0,-3954795,2018-06-15,2018-06-15,Groceries
40906174,325516,0,-4280311,2018-06-15,2018-06-15,Utilities
40906174,0,444389,-3835922,2018-06-16,2018-06-16,
40906174,451919,0,-4287841,2018-06-17,2018-06-17,Bill Sharing
40906174,382881,0,-4670722,2018-06-17,2018-06-17,Entertainment
40906174,11597,0,-4682319,2018-06-18,2018-06-18,Transportation
40906174,12545,0,-4694864,2018-06-18,2018-06-18,Rent
40906174,0,18580,-4676284,2018-06-18,2018-06-18,
40906174,16851,0,-4693135,2018-06-19,2018-06-19,Clothes
40906174,0,14634,-4678501,2018-06-19,2018-06-19,
40906174,17784,0,-4696285,2018-06-20,2018-06-20,Education
40906174,0,630399,-4711032,2018-06-20,2018-06-20,
40906174,11395,0,-4722427,2018-06-20,2018-06-20,Bill Sharing
40906174,0,356578,-4365849,2018-06-21,2018-06-21,
40906174,472500,0,-4838349,2018-06-22,2018-06-22,Healthcare
40906174,0,434222,-4404127,2018-06-23,2018-06-23,
40906174,340602,0,-4744729,2018-06-24,2018-06-24,Healthcare
40906174,301983,0,-5046712,2018-06-24,2018-06-24,Groceries
40906174,14624,0,-5061336,2018-06-24,2018-06-24,Rent
40906174,384197,0,-5445533,2018-06-25,2018-06-25,Entertainment
40906174,14559,0,-5460092,2018-06-25,2018-06-25,Bill Sharing
40906174,498862,0,-5958954,2018-06-25,2018-06-25,Groceries
40906174,0,373476,-5585478,2018-06-26,2018-06-26,
40906174,10465,0,-5595943,2018-06-26,2018-06-26,Rent
40906174,311055,0,-5906998,2018-06-27,2018-06-27,Healthcare
40906174,315580,0,-6222578,2018-06-28,2018-06-28,Rent
40906174,0,15296,-6207282,2018-06-28,2018-06-28,
40906174,0,17038,-6190244,2018-06-29,2018-06-29,
40906174,0,11151,-6179093,2018-06-30,2018-06-30,
40906174,0,391184,-5787909,2018-06-30,2018-06-30,
40906174,0,12420,-5775489,2018-07-01,2018-07-01,
40906174,391050,0,-6166539,2018-07-02,2018-07-02,Groceries
40906174,374794,0,-6541333,2018-07-02,2018-07-02,Entertainment
40906174,10687,0,-6552020,2018-07-02,2018-07-02,Rent
40906174,0,354194,-6197826,2018-07-03,2018-07-03,
40906174,393539,0,-6591365,2018-07-03,2018-07-03,Entertainment
40906174,441654,0,-7033019,2018-07-04,2018-07-04,Healthcare
40906174,371307,0,-7404326,2018-07-04,2018-07-04,Utilities
40906174,15093,0,-7419419,2018-07-05,2018-07-05,Rent
40906174,0,15344,-7404075,2018-07-05,2018-07-05,
40906174,0,11824,-7392251,2018-07-05,2018-07-05,
40906174,0,10907,-7381344,2018-07-06,2018-07-06,
40906174,0,404152,-6977192,2018-07-06,2018-07-06,
40906174,0,12312,-6964880,2018-07-07,2018-07-07,
40906174,14553,0,-6979433,2018-07-07,2018-07-07,Utilities
40906174,0,16651,-6962782,2018-07-08,2018-07-08,
40906174,0,17101,-6945681,2018-07-08,2018-07-08,
40906174,0,313091,-6632590,2018-07-09,2018-07-09,
40906174,13305,0,-6645895,2018-07-09,2018-07-09,Education
40906174,0,440335,-6205560,2018-07-09,2018-07-09,
40906174,0,426863,-5778697,2018-07-10,2018-07-10,
40906174,0,470102,-5308595,2018-07-11,2018-07-11,
40906174,473447,0,-5782042,2018-07-11,2018-07-11,Healthcare
40906174,379338,0,-6161380,2018-07-12,2018-07-12,Groceries
40906174,429027,0,-6590407,2018-07-13,2018-07-13,Groceries
40906174,457526,0,-7047933,2018-07-13,2018-07-13,Healthcare
40906174,0,323077,-6724856,2018-07-13,2018-07-13,
40906174,0,329527,-6395329,2018-07-14,2018-07-14,
40906174,403374,0,-6798703,2018-07-15,2018-07-15,Education
40906174,0,429294,-6369409,2018-07-15,2018-07-15,
40906174,492046,0,-6861455,2018-07-15,2018-07-15,Bill Sharing
40906174,452060,0,-7313515,2018-07-16,2018-07-16,Groceries
40906174,0,15151,-7298364,2018-07-17,2018-07-17,
40906174,409263,0,-7707627,2018-07-17,2018-07-17,Bill Sharing
40906174,0,19223,-7688404,2018-07-18,2018-07-18,
40906174,345395,0,-8033799,2018-07-18,2018-07-18,Education
40906174,0,333420,-7700379,2018-07-18,2018-07-18,
40906174,0,14329,-7686050,2018-07-19,2018-07-19,
40906174,0,17939,-7668111,2018-07-20,2018-07-20,
40906174,14522,0,-7682633,2018-07-21,2018-07-21,Entertainment
40906174,463078,0,-8145711,2018-07-22,2018-07-22,Entertainment
40906174,0,466339,-7679372,2018-07-22,2018-07-22,
40906174,0,466855,-7212517,2018-07-23,2018-07-23,
40906174,300855,0,-7513372,2018-07-24,2018-07-24,Clothes
40906174,480444,0,-7993816,2018-07-24,2018-07-24,Entertainment
40906174,385276,0,-8379092,2018-07-25,2018-07-25,Utilities
40906174,13032,0,-8392124,2018-07-25,2018-07-25,Rent
40906174,373212,0,-8765336,2018-07-25,2018-07-25,Bill Sharing
40906174,441043,0,-9206379,2018-07-26,2018-07-26,Utilities
40906174,12980,0,-9219359,2018-07-27,2018-07-27,Education
40906174,15815,0,-9235174,2018-07-27,2018-07-27,Transportation
40906174,490597,0,-9725771,2018-07-28,2018-07-28,Healthcare
40906174,18664,0,-9744435,2018-07-28,2018-07-28,Rent
40906174,0,463816,-9280619,2018-07-28,2018-07-28,
40906174,11447,0,-9292066,2018-07-29,2018-07-29,Entertainment
40906174,472507,0,-9764573,2018-07-29,2018-07-29,Utilities
40906174,497471,0,-10262044,2018-07-29,2018-07-29,Rent
40906174,0,18794,-10243250,2018-07-30,2018-07-30,
40906174,0,333273,-9909977,2018-07-31,2018-07-31,
40906174,0,467369,-9442608,2018-08-01,2018-08-01,
40906174,315612,0,-9758220,2018-08-01,2018-08-01,Clothes
40906174,348184,0,-10106404,2018-08-01,2018-08-01,Education
40906174,10629,0,-10117033,2018-08-02,2018-08-02,Rent
40906174,13496,0,-10130529,2018-08-02,2018-08-02,Rent
40906174,0,18614,-10111915,2018-08-03,2018-08-03,
40906174,16191,0,-10128106,2018-08-03,2018-08-03,Bill Sharing
40906174,0,304865,-9823241,2018-08-04,2018-08-04,
40906174,0,496129,-9327112,2018-08-04,2018-08-04,
40906174,0,10353,-9316759,2018-08-04,2018-08-04,
40906174,0,462328,-8854431,2018-08-05,2018-08-05,
40906174,0,306881,-8547550,2018-08-06,2018-08-06,
40906174,0,433538,-8114012,2018-08-06,2018-08-06,
40906174,15533,0,-8129545,2018-08-06,2018-08-06,Transportation
40906174,425909,0,-8555454,2018-08-07,2018-08-07,Groceries
40906174,418997,0,-8974451,2018-08-07,2018-08-07,Transportation
40906174,477818,0,-9452269,2018-08-07,2018-08-07,Bill Sharing
40906174,0,301978,-9150291,2018-08-08,2018-08-08,
40906174,328305,0,-9478596,2018-08-08,2018-08-08,Bill Sharing
40906174,404862,0,-9883458,2018-08-08,2018-08-08,Transportation
40906174,16857,0,-9900315,2018-08-09,2018-08-09,Transportation
40906174,0,15453,-9884862,2018-08-09,2018-08-09,
40906174,337402,0,-10222264,2018-08-09,2018-08-09,Education
40906174,482878,0,-10705142,2018-08-10,2018-08-10,Groceries
40906174,19813,0,-10724955,2018-08-10,2018-08-10,Rent
40906174,0,14045,-10710910,2018-08-10,2018-08-10,
40906174,0,330436,-10380474,2018-08-11,2018-08-11,
40906174,14208,0,-10394682,2018-08-11,2018-08-11,Education
40906174,0,16791,-10377891,2018-08-11,2018-08-11,
40906174,13147,0,-10391038,2018-08-12,2018-08-12,Rent
40906174,472343,0,-10863381,2018-08-12,2018-08-12,Groceries
40906174,413832,0,-11277213,2018-08-12,2018-08-12,Transportation
40906174,0,388956,-10888257,2018-08-13,2018-08-13,
40906174,0,327969,-10560288,2018-08-13,2018-08-13,
40906174,446317,0,-11006605,2018-08-13,2018-08-13,Entertainment
40906174,408057,0,-11414662,2018-08-14,2018-08-14,Utilities
40906174,0,378744,-11035918,2018-08-15,2018-08-15,
40906174,426524,0,-11462442,2018-08-15,2018-08-15,Bill Sharing
40906174,0,312715,-11149727,2018-08-16,2018-08-16,
40906174,0,368804,-10780923,2018-08-16,2018-08-16,
40906174,0,458642,-10322281,2018-08-17,2018-08-17,
40906174,0,498440,-9823841,2018-08-18,2018-08-18,
40906174,11557,0,-9835398,2018-08-19,2018-08-19,Healthcare
40906174,470968,0,-10306366,2018-08-19,2018-08-19,Clothes
40906174,0,432701,-9873665,2018-08-20,2018-08-20,
40906174,13503,0,-9887168,2018-08-20,2018-08-20,Clothes
40906174,0,11689,-9875479,2018-08-21,2018-08-21,
40906174,0,432963,-9442516,2018-08-21,2018-08-21,
40906174,19708,0,-9462224,2018-08-21,2018-08-21,Transportation
40906174,15869,0,-9478093,2018-08-22,2018-08-22,Transportation
40906174,0,336701,-9141392,2018-08-23,2018-08-23,
40906174,0,13993,-9127399,2018-08-24,2018-08-24,
40906174,0,10509,-9116890,2018-08-24,2018-08-24,
40906174,0,11356,-9105534,2018-08-25,2018-08-25,
40906174,406257,0,-9511791,2018-08-25,2018-08-25,Clothes
40906174,354251,0,-9866042,2018-08-26,2018-08-26,Utilities
40906174,397485,0,-10263527,2018-08-26,2018-08-26,Groceries
40906174,11232,0,-10274759,2018-08-27,2018-08-27,Education
40906174,18765,0,-10293524,2018-08-27,2018-08-27,Rent
40906174,303148,0,-10596672,2018-08-27,2018-08-27,Education
40906174,0,17548,-10579124,2018-08-28,2018-08-28,
40906174,443870,0,-11022994,2018-08-29,2018-08-29,Transportation
40906174,458703,0,-11481697,2018-08-29,2018-08-29,Utilities
40906174,0,456862,-11024835,2018-08-30,2018-08-30,
40906174,491419,0,-11516254,2018-08-30,2018-08-30,Rent
40906174,385873,0,-11902127,2018-08-30,2018-08-30,Clothes
40906174,0,412800,-11489327,2018-08-31,2018-08-31,
40906174,0,10702,-11478625,2018-08-31,2018-08-31,
40906174,430260,0,-11908885,2018-08-31,2018-08-31,Rent
40906174,16919,0,-11925804,2018-09-01,2018-09-01,Utilities
40906174,362335,0,-12288139,2018-09-01,2018-09-01,Bill Sharing
40906174,405936,0,-12694075,2018-09-01,2018-09-01,Clothes
40906174,0,16428,-12677647,2018-09-02,2018-09-02,
40906174,340674,0,-13018321,2018-09-02,2018-09-02,Utilities
40906174,0,417588,-12600733,2018-09-02,2018-09-02,
40906174,339864,0,-12940597,2018-09-03,2018-09-03,Transportation
40906174,452766,0,-13393363,2018-09-04,2018-09-04,Groceries
40906174,452529,0,-13845892,2018-09-04,2018-09-04,Clothes
40906174,0,315392,-13530500,2018-09-05,2018-09-05,
40906174,0,404513,-13125987,2018-09-05,2018-09-05,
40906174,0,14742,-13111245,2018-09-06,2018-09-06,
40906174,421758,0,-13533003,2018-09-06,2018-09-06,Rent
40906174,0,315546,-13217457,2018-09-07,2018-09-07,
40906174,875627,0,-13205502,2018-09-08,2018-09-08,Education
40906174,0,332484,-12873018,2018-09-08,2018-09-08,
40906174,0,317862,-12555156,2018-09-09,2018-09-09,
40906174,10824,0,-12565980,2018-09-10,2018-09-10,Transportation
40906174,404060,0,-12970040,2018-09-11,2018-09-11,Groceries
40906174,449510,0,-13419550,2018-09-11,2018-09-11,Bill Sharing
40906174,0,18413,-13401137,2018-09-12,2018-09-12,
40906174,0,602602,-12978191,2018-09-13,2018-09-13,
40906174,10348,0,-12988539,2018-09-13,2018-09-13,Bill Sharing
40906174,0,386785,-12601754,2018-09-13,2018-09-13,
40906174,444242,0,-13045996,2018-09-14,2018-09-14,Groceries
40906174,0,346598,-12699398,2018-09-14,2018-09-14,
40906174,343183,0,-13042581,2018-09-14,2018-09-14,Entertainment
40906174,0,393717,-12648864,2018-09-15,2018-09-15,
40906174,423512,0,-13072376,2018-09-15,2018-09-15,Rent
40906174,17263,0,-13089639,2018-09-15,2018-09-15,Healthcare
40906174,0,11495,-13078144,2018-09-16,2018-09-16,
40906174,402498,0,-13480642,2018-09-16,2018-09-16,Groceries
40906174,0,14154,-13466488,2018-09-16,2018-09-16,
40906174,382557,0,-13849045,2018-09-17,2018-09-17,Bill Sharing
40906174,675590,0,-13364754,2018-09-18,2018-09-18,Healthcare
40906174,419710,0,-13784464,2018-09-18,2018-09-18,Rent
40906174,0,391666,-13392798,2018-09-19,2018-09-19,
40906174,477268,0,-13870066,2018-09-19,2018-09-19,Transportation
40906174,0,11765,-13858301,2018-09-20,2018-09-20,
40906174,10155,0,-13868456,2018-09-20,2018-09-20,Utilities
40906174,985113,0,-13881540,2018-09-20,2018-09-20,Education
40906174,0,753219,-14337473,2018-09-21,2018-09-21,
40906174,0,443696,-13893777,2018-09-22,2018-09-22,
40906174,311552,0,-14205329,2018-09-22,2018-09-22,Education
40906174,482954,0,-14688283,2018-09-22,2018-09-22,Bill Sharing
40906174,0,15930,-14672353,2018-09-23,2018-09-23,
40906174,0,16495,-14655858,2018-09-24,2018-09-24,
40906174,0,491263,-14164595,2018-09-24,2018-09-24,
40906174,16224,0,-14180819,2018-09-24,2018-09-24,Education
40906174,0,12673,-14168146,2018-09-25,2018-09-25,
40906174,0,15252,-14152894,2018-09-25,2018-09-25,
40906174,422750,0,-14575644,2018-09-25,2018-09-25,Rent
40906174,406788,0,-14982432,2018-09-26,2018-09-26,Clothes
40906174,0,18163,-14964269,2018-09-26,2018-09-26,
40906174,373829,0,-15338098,2018-09-26,2018-09-26,Education
40906174,0,433473,-14904625,2018-09-27,2018-09-27,
40906174,0,11270,-14893355,2018-09-28,2018-09-28,
40906174,0,395550,-14497805,2018-09-28,2018-09-28,
40906174,490752,0,-14988557,2018-09-28,2018-09-28,Rent
40906174,431142,0,-15419699,2018-09-29,2018-09-29,Bill Sharing
40906174,347383,0,-15767082,2018-09-30,2018-09-30,Clothes
40906174,0,353507,-15413575,2018-09-30,2018-09-30,
40906174,476921,0,-15890496,2018-10-01,2018-10-01,Bill Sharing
40906174,0,17953,-15872543,2018-10-02,2018-10-02,
40906174,0,15675,-15856868,2018-10-02,2018-10-02,
40906174,16553,0,-15873421,2018-10-03,2018-10-03,Healthcare
40906174,0,16299,-15857122,2018-10-04,2018-10-04,
40906174,0,317173,-15539949,2018-10-04,2018-10-04,
40906174,10971,0,-15550920,2018-10-04,2018-10-04,Education
40906174,13413,0,-15564333,2018-10-05,2018-10-05,Transportation
40906174,0,11683,-15552650,2018-10-05,2018-10-05,
40906174,0,419667,-15132983,2018-10-06,2018-10-06,
40906174,0,356993,-14775990,2018-10-06,2018-10-06,
40906174,378463,0,-15154453,2018-10-07,2018-10-07,Utilities
40906174,0,14642,-15139811,2018-10-08,2018-10-08,
40906174,19661,0,-15159472,2018-10-09,2018-10-09,Utilities
40906174,374622,0,-15534094,2018-10-09,2018-10-09,Healthcare
40906174,11515,0,-15545609,2018-10-10,2018-10-10,Entertainment
40906174,0,12846,-15532763,2018-10-10,2018-10-10,
40906174,0,458450,-15074313,2018-10-10,2018-10-10,
40906174,0,18459,-15055854,2018-10-11,2018-10-11,
40906174,19582,0,-15075436,2018-10-12,2018-10-12,Groceries
40906174,0,379084,-14696352,2018-10-13,2018-10-13,
40906174,18224,0,-14714576,2018-10-13,2018-10-13,Groceries
40906174,0,17231,-14697345,2018-10-13,2018-10-13,
40906174,0,447043,-14250302,2018-10-14,2018-10-14,
40906174,0,418721,-13831581,2018-10-14,2018-10-14,
40906174,0,338710,-13492871,2018-10-15,2018-10-15,
40906174,429357,0,-13922228,2018-10-15,2018-10-15,Education
40906174,0,459210,-13463018,2018-10-16,2018-10-16,
40906174,0,323726,-13139292,2018-10-16,2018-10-16,
40906174,411031,0,-13550323,2018-10-17,2018-10-17,Transportation
40906174,0,360569,-13189754,2018-10-17,2018-10-17,
40906174,14847,0,-13204601,2018-10-18,2018-10-18,Entertainment
40906174,310477,0,-13515078,2018-10-18,2018-10-18,Groceries
40906174,461547,0,-13976625,2018-10-19,2018-10-19,Rent
40906174,0,382495,-13594130,2018-10-19,2018-10-19,
40906174,0,11468,-13582662,2018-10-19,2018-10-19,
40906174,12371,0,-13595033,2018-10-20,2018-10-20,Transportation
40906174,376480,0,-13971513,2018-10-20,2018-10-20,Bill Sharing
40906174,0,334799,-13636714,2018-10-20,2018-10-20,
40906174,472755,0,-14109469,2018-10-21,2018-10-21,Entertainment
40906174,0,366452,-13743017,2018-10-21,2018-10-21,
40906174,376805,0,-14119822,2018-10-22,2018-10-22,Transportation
40906174,0,363466,-13756356,2018-10-23,2018-10-23,
40906174,331446,0,-14087802,2018-10-24,2018-10-24,Rent
40906174,0,362069,-13725733,2018-10-24,2018-10-24,
40906174,0,17915,-13707818,2018-10-25,2018-10-25,
40906174,0,10670,-13697148,2018-10-25,2018-10-25,
40906174,0,414245,-13282903,2018-10-25,2018-10-25,
40906174,0,391435,-12891468,2018-10-26,2018-10-26,
40906174,0,18073,-12873395,2018-10-26,2018-10-26,
40906174,351697,0,-13225092,2018-10-27,2018-10-27,Entertainment
40906174,0,18281,-13206811,2018-10-27,2018-10-27,
40906174,384255,0,-13591066,2018-10-27,2018-10-27,Transportation
40906174,19836,0,-13610902,2018-10-28,2018-10-28,Clothes
40906174,0,421450,-13189452,2018-10-28,2018-10-28,
40906174,445818,0,-13635270,2018-10-28,2018-10-28,Healthcare
40906174,0,302759,-13332511,2018-10-29,2018-10-29,
40906174,0,309749,-13022762,2018-10-29,2018-10-29,
40906174,435605,0,-13458367,2018-10-29,2018-10-29,Rent
40906174,15748,0,-13474115,2018-10-30,2018-10-30,Clothes
40906174,0,360162,-13113953,2018-10-30,2018-10-30,
40906174,0,324297,-12789656,2018-10-31,2018-10-31,
40906174,0,15973,-12773683,2018-10-31,2018-10-31,
40906174,0,487529,-12286154,2018-10-31,2018-10-31,
40906174,0,457629,-11828525,2018-11-01,2018-11-01,
40906174,0,422064,-11406461,2018-11-01,2018-11-01,
40906174,378068,0,-11784529,2018-11-01,2018-11-01,Utilities
40906174,414811,0,-12199340,2018-11-02,2018-11-02,Clothes
40906174,18551,0,-12217891,2018-11-02,2018-11-02,Transportation
40906174,0,433258,-11784633,2018-11-03,2018-11-03,
40906174,0,19241,-11765392,2018-11-04,2018-11-04,
40906174,420070,0,-12185462,2018-11-04,2018-11-04,Education
40906174,355540,0,-12541002,2018-11-05,2018-11-05,Clothes
40906174,0,471067,-12069935,2018-11-05,2018-11-05,
40906174,19789,0,-12089724,2018-11-06,2018-11-06,Entertainment
40906174,0,19955,-12069769,2018-11-07,2018-11-07,
40906174,0,11349,-12058420,2018-11-07,2018-11-07,
40906174,15874,0,-12074294,2018-11-08,2018-11-08,Rent
40906174,0,350411,-11723883,2018-11-08,2018-11-08,
40906174,0,341645,-11382238,2018-11-09,2018-11-09,
40906174,0,442440,-10939798,2018-11-09,2018-11-09,
40906174,0,485540,-10454258,2018-11-10,2018-11-10,
40906174,12223,0,-10466481,2018-11-10,2018-11-10,Utilities
40906174,0,953952,-10453724,2018-11-10,2018-11-10,
40906174,306749,0,-10760473,2018-11-11,2018-11-11,Healthcare
40906174,10477,0,-10770950,2018-11-11,2018-11-11,Groceries
40906174,0,11030,-10759920,2018-11-12,2018-11-12,
40906174,0,335058,-10424862,2018-11-12,2018-11-12,
40906174,0,470415,-9954447,2018-11-13,2018-11-13,
40906174,0,300409,-9654038,2018-11-13,2018-11-13,
40906174,320134,0,-9974172,2018-11-14,2018-11-14,Education
40906174,0,303030,-9671142,2018-11-15,2018-11-15,
40906174,460077,0,-10131219,2018-11-16,2018-11-16,Groceries
40906174,13225,0,-10144444,2018-11-16,2018-11-16,Clothes
40906174,414262,0,-10558706,2018-11-16,2018-11-16,Bill Sharing
40906174,0,16858,-10541848,2018-11-17,2018-11-17,
40906174,0,10424,-10531424,2018-11-17,2018-11-17,
40906174,15606,0,-10547030,2018-11-17,2018-11-17,Rent
40906174,0,443803,-10103227,2018-11-18,2018-11-18,
40906174,416067,0,-10519294,2018-11-19,2018-11-19,Education
40906174,359325,0,-10878619,2018-11-19,2018-11-19,Rent
40906174,13611,0,-10892230,2018-11-20,2018-11-20,Healthcare
40906174,481347,0,-11373577,2018-11-20,2018-11-20,Clothes
40906174,0,431048,-10942529,2018-11-20,2018-11-20,
40906174,0,455828,-10486701,2018-11-21,2018-11-21,
40906174,11646,0,-10498347,2018-11-21,2018-11-21,Transportation
40906174,0,339531,-10158816,2018-11-22,2018-11-22,
40906174,12305,0,-10171121,2018-11-22,2018-11-22,Education
40906174,0,352456,-9818665,2018-11-22,2018-11-22,
40906174,0,393360,-9425305,2018-11-23,2018-11-23,
40906174,0,459677,-8965628,2018-11-24,2018-11-24,
40906174,18631,0,-8984259,2018-11-24,2018-11-24,Entertainment
40906174,0,410881,-8573378,2018-11-25,2018-11-25,
40906174,372961,0,-8946339,2018-11-26,2018-11-26,Rent
40906174,0,18033,-8928306,2018-11-26,2018-11-26,
40906174,0,12249,-8916057,2018-11-27,2018-11-27,
40906174,14495,0,-8930552,2018-11-27,2018-11-27,Transportation
40906174,335695,0,-9266247,2018-11-27,2018-11-27,Transportation
40906174,0,461417,-8804830,2018-11-28,2018-11-28,
40906174,0,477159,-8327671,2018-11-28,2018-11-28,
40906174,625521,0,-8695918,2018-11-29,2018-11-29,Healthcare
40906174,0,341849,-8354069,2018-11-29,2018-11-29,
40906174,11857,0,-8365926,2018-11-30,2018-11-30,Education
40906174,0,470670,-7895256,2018-11-30,2018-11-30,
40906174,13942,0,-7909198,2018-11-30,2018-11-30,Healthcare
40906174,588706,0,-8304213,2018-12-01,2018-12-01,Education
40906174,0,794237,-8287301,2018-12-01,2018-12-01,
40906174,412561,0,-8699862,2018-12-01,2018-12-01,Groceries
40906174,408007,0,-9107869,2018-12-02,2018-12-02,Groceries
40906174,0,10993,-9096876,2018-12-03,2018-12-03,
40906174,490537,0,-9587413,2018-12-03,2018-12-03,Clothes
40906174,366154,0,-9953567,2018-12-04,2018-12-04,Utilities
40906174,436163,0,-10389730,2018-12-04,2018-12-04,Groceries
40906174,425003,0,-10814733,2018-12-04,2018-12-04,Rent
40906174,16938,0,-10831671,2018-12-05,2018-12-05,Entertainment
40906174,474926,0,-11306597,2018-12-05,2018-12-05,Clothes
40906174,0,330515,-10976082,2018-12-05,2018-12-05,
40906174,0,300065,-10676017,2018-12-06,2018-12-06,
40906174,0,16019,-10659998,2018-12-07,2018-12-07,
40906174,391573,0,-11051571,2018-12-07,2018-12-07,Healthcare
40906174,11326,0,-11062897,2018-12-07,2018-12-07,Education
40906174,0,376410,-10686487,2018-12-08,2018-12-08,
40906174,0,447741,-10238746,2018-12-08,2018-12-08,
40906174,16472,0,-10255218,2018-12-09,2018-12-09,Clothes
40906174,0,11980,-10243238,2018-12-10,2018-12-10,
40906174,400736,0,-10643974,2018-12-10,2018-12-10,Education
40906174,0,12698,-10631276,2018-12-10,2018-12-10,
40906174,16249,0,-10647525,2018-12-11,2018-12-11,Clothes
40906174,332056,0,-10979581,2018-12-11,2018-12-11,Clothes
40906174,305570,0,-11285151,2018-12-11,2018-12-11,Clothes
40906174,497407,0,-11782558,2018-12-12,2018-12-12,Healthcare
40906174,0,432995,-11349563,2018-12-13,2018-12-13,
40906174,0,312208,-11037355,2018-12-13,2018-12-13,
40906174,0,337298,-10700057,2018-12-13,2018-12-13,
40906174,16768,0,-10716825,2018-12-14,2018-12-14,Bill Sharing
40906174,335518,0,-11052343,2018-12-14,2018-12-14,Rent
40906174,319563,0,-11371906,2018-12-15,2018-12-15,Groceries
40906174,0,15542,-11356364,2018-12-16,2018-12-16,
40906174,386594,0,-11742958,2018-12-16,2018-12-16,Utilities
40906174,0,417302,-11325656,2018-12-16,2018-12-16,
40906174,0,17915,-11307741,2018-12-17,2018-12-17,
40906174,0,479718,-10828023,2018-12-17,2018-12-17,
40906174,0,402877,-10425146,2018-12-17,2018-12-17,
40906174,18705,0,-10443851,2018-12-18,2018-12-18,Entertainment
40906174,0,17353,-10426498,2018-12-19,2018-12-19,
40906174,0,362904,-10063594,2018-12-20,2018-12-20,
40906174,458700,0,-10522294,2018-12-20,2018-12-20,Healthcare
40906174,338094,0,-10860388,2018-12-21,2018-12-21,Entertainment
40906174,16853,0,-10877241,2018-12-21,2018-12-21,Rent
40906174,0,15320,-10861921,2018-12-22,2018-12-22,
40906174,0,19775,-10842146,2018-12-22,2018-12-22,
40906174,403360,0,-11245506,2018-12-23,2018-12-23,Clothes
40906174,449362,0,-11694868,2018-12-23,2018-12-23,Clothes
40906174,0,412681,-11282187,2018-12-24,2018-12-24,
40906174,0,13351,-11268836,2018-12-25,2018-12-25,
40906174,479475,0,-11748311,2018-12-25,2018-12-25,Rent
40906174,13107,0,-11761418,2018-12-26,2018-12-26,Entertainment
40906174,0,19171,-11742247,2018-12-27,2018-12-27,
40906174,13935,0,-11756182,2018-12-27,2018-12-27,Bill Sharing
40906174,0,373993,-11382189,2018-12-27,2018-12-27,
40906174,347084,0,-11729273,2018-12-28,2018-12-28,Clothes
40906174,0,16037,-11713236,2018-12-28,2018-12-28,
40906174,361145,0,-12074381,2018-12-28,2018-12-28,Clothes
40906174,0,376592,-11697789,2018-12-29,2018-12-29,
40906174,10003,0,-11707792,2018-12-30,2018-12-30,Transportation
40906174,0,422781,-11285011,2018-12-30,2018-12-30,
40906174,0,15412,-11269599,2018-12-31,2018-12-31,
40906174,445682,0,-11715281,2019-01-01,2019-01-01,Rent
40906174,0,491290,-11223991,2019-01-02,2019-01-02,
40906174,0,391356,-10832635,2019-01-03,2019-01-03,
40906174,19072,0,-10851707,2019-01-04,2019-01-04,Healthcare
40906174,0,382000,-10469707,2019-01-05,2019-01-05,
40906174,0,406054,-10063653,2019-01-05,2019-01-05,
40906174,327078,0,-10390731,2019-01-05,2019-01-05,Transportation
40906174,670104,0,-10029993,2019-01-06,2019-01-06,Education
40906174,0,486030,-9543963,2019-01-06,2019-01-06,
40906174,478998,0,-10022961,2019-01-06,2019-01-06,Education
40906174,16077,0,-10039038,2019-01-07,2019-01-07,Entertainment
40906174,0,17768,-10021270,2019-01-07,2019-01-07,
40906174,0,395095,-9626175,2019-01-07,2019-01-07,
40906174,403402,0,-10029577,2019-01-08,2019-01-08,Utilities
40906174,0,11291,-10018286,2019-01-08,2019-01-08,
40906174,582704,0,-9648504,2019-01-08,2019-01-08,Education
40906174,0,12907,-9635597,2019-01-09,2019-01-09,
40906174,328852,0,-9964449,2019-01-10,2019-01-10,Bill Sharing
40906174,0,15448,-9949001,2019-01-11,2019-01-11,
40906174,18039,0,-9967040,2019-01-12,2019-01-12,Entertainment
40906174,407313,0,-10374353,2019-01-12,2019-01-12,Utilities
40906174,14445,0,-10388798,2019-01-13,2019-01-13,Rent
40906174,362754,0,-10751552,2019-01-13,2019-01-13,Rent
40906174,0,18909,-10732643,2019-01-13,2019-01-13,
40906174,0,330964,-10401679,2019-01-14,2019-01-14,
40906174,18594,0,-10420273,2019-01-14,2019-01-14,Groceries
40906174,0,11685,-10408588,2019-01-15,2019-01-15,
40906174,472694,0,-10881282,2019-01-15,2019-01-15,Groceries
40906174,0,12918,-10868364,2019-01-15,2019-01-15,
40906174,0,15418,-10852946,2019-01-16,2019-01-16,
40906174,0,16402,-10836544,2019-01-17,2019-01-17,
40906174,438733,0,-11275277,2019-01-17,2019-01-17,Education
40906174,319528,0,-11594805,2019-01-17,2019-01-17,Education
40906174,10073,0,-11604878,2019-01-18,2019-01-18,Utilities
40906174,17184,0,-11622062,2019-01-19,2019-01-19,Education
40906174,0,340215,-11281847,2019-01-20,2019-01-20,
40906174,0,445950,-10835897,2019-01-21,2019-01-21,
40906174,0,489522,-10346375,2019-01-21,2019-01-21,
40906174,489631,0,-10836006,2019-01-21,2019-01-21,Transportation
40906174,0,19965,-10816041,2019-01-22,2019-01-22,
40906174,465790,0,-11281831,2019-01-23,2019-01-23,Entertainment
40906174,0,460294,-10821537,2019-01-24,2019-01-24,
40906174,489915,0,-11311452,2019-01-24,2019-01-24,Groceries
40906174,18587,0,-11330039,2019-01-24,2019-01-24,Utilities
40906174,0,11427,-11318612,2019-01-25,2019-01-25,
40906174,0,17264,-11301348,2019-01-26,2019-01-26,
40906174,12039,0,-11313387,2019-01-26,2019-01-26,Utilities
40906174,17869,0,-11331256,2019-01-26,2019-01-26,Rent
40906174,0,338584,-10992672,2019-01-27,2019-01-27,
40906174,344207,0,-11336879,2019-01-27,2019-01-27,Rent
40906174,0,464950,-10871929,2019-01-28,2019-01-28,
40906174,0,19071,-10852858,2019-01-29,2019-01-29,
40906174,0,430746,-10422112,2019-01-30,2019-01-30,
40906174,0,12485,-10409627,2019-01-30,2019-01-30,
40906174,10855,0,-10420482,2019-01-31,2019-01-31,Entertainment
40906174,12605,0,-10433087,2019-01-31,2019-01-31,Groceries
40906174,11055,0,-10444142,2019-02-01,2019-02-01,Groceries
40906174,0,314057,-10130085,2019-02-01,2019-02-01,
40906174,16445,0,-10146530,2019-02-02,2019-02-02,Bill Sharing
40906174,316011,0,-10462541,2019-02-02,2019-02-02,Groceries
40906174,0,430130,-10032411,2019-02-02,2019-02-02,
40906174,11024,0,-10043435,2019-02-03,2019-02-03,Groceries
40906174,13003,0,-10056438,2019-02-04,2019-02-04,Clothes
40906174,0,315909,-9740529,2019-02-04,2019-02-04,
40906174,11958,0,-9752487,2019-02-04,2019-02-04,Transportation
40906174,0,391424,-9361063,2019-02-05,2019-02-05,
40906174,0,486744,-8874319,2019-02-06,2019-02-06,
40906174,0,12854,-8861465,2019-02-06,2019-02-06,
40906174,0,930204,-8369107,2019-02-07,2019-02-07,
40906174,0,10255,-8358852,2019-02-08,2019-02-08,
40906174,0,392720,-7966132,2019-02-09,2019-02-09,
40906174,0,319507,-7646625,2019-02-10,2019-02-10,
40906174,0,331609,-7315016,2019-02-10,2019-02-10,
40906174,0,11512,-7303504,2019-02-11,2019-02-11,
40906174,0,18163,-7285341,2019-02-12,2019-02-12,
40906174,439440,0,-7724781,2019-02-13,2019-02-13,Healthcare
40906174,0,18028,-7706753,2019-02-14,2019-02-14,
40906174,0,318437,-7388316,2019-02-14,2019-02-14,
40906174,17633,0,-7405949,2019-02-14,2019-02-14,Healthcare
40906174,0,14100,-7391849,2019-02-15,2019-02-15,
40906174,469882,0,-7861731,2019-02-16,2019-02-16,Transportation
40906174,0,12102,-7849629,2019-02-16,2019-02-16,
40906174,488838,0,-8338467,2019-02-16,2019-02-16,Clothes
40906174,454394,0,-8792861,2019-02-17,2019-02-17,Entertainment
40906174,347556,0,-9140417,2019-02-17,2019-02-17,Healthcare
40906174,0,18048,-9122369,2019-02-18,2019-02-18,
40906174,0,10041,-9112328,2019-02-18,2019-02-18,
40906174,0,17493,-9094835,2019-02-18,2019-02-18,
40906174,0,781673,-8741065,2019-02-19,2019-02-19,
40906174,0,16085,-8724980,2019-02-19,2019-02-19,
40906174,386171,0,-9111151,2019-02-19,2019-02-19,Education
40906174,0,15545,-9095606,2019-02-20,2019-02-20,
40906174,421937,0,-9517543,2019-02-20,2019-02-20,Bill Sharing
40906174,0,12342,-9505201,2019-02-20,2019-02-20,
40906174,422244,0,-9927445,2019-02-21,2019-02-21,Transportation
40906174,0,402225,-9525220,2019-02-21,2019-02-21,
40906174,0,14598,-9510622,2019-02-21,2019-02-21,
40906174,432311,0,-9942933,2019-02-22,2019-02-22,Healthcare
40906174,424090,0,-10367023,2019-02-23,2019-02-23,Healthcare
40906174,0,412629,-9954394,2019-02-24,2019-02-24,
40906174,0,406071,-9548323,2019-02-24,2019-02-24,
40906174,12374,0,-9560697,2019-02-24,2019-02-24,Education
40906174,353937,0,-9914634,2019-02-25,2019-02-25,Utilities
40906174,451015,0,-10365649,2019-02-25,2019-02-25,Bill Sharing
40906174,0,319476,-10046173,2019-02-26,2019-02-26,
40906174,13505,0,-10059678,2019-02-26,2019-02-26,Utilities
40906174,0,354252,-9705426,2019-02-27,2019-02-27,
40906174,0,10066,-9695360,2019-02-27,2019-02-27,
40906174,0,484831,-9210529,2019-02-27,2019-02-27,
40906174,0,13985,-9196544,2019-02-28,2019-02-28,
40906174,305573,0,-9502117,2019-03-01,2019-03-01,Rent
40906174,0,420773,-9081344,2019-03-01,2019-03-01,
40906174,606094,0,-9509107,2019-03-01,2019-03-01,Education
40906174,405700,0,-9914807,2019-03-02,2019-03-02,Bill Sharing
40906174,0,339815,-9574992,2019-03-03,2019-03-03,
40906174,17798,0,-9592790,2019-03-03,2019-03-03,Clothes
40906174,0,404796,-9187994,2019-03-03,2019-03-03,
40906174,424667,0,-9612661,2019-03-04,2019-03-04,Transportation
40906174,0,11618,-9601043,2019-03-04,2019-03-04,
40906174,13049,0,-9614092,2019-03-05,2019-03-05,Healthcare
40906174,11914,0,-9626006,2019-03-05,2019-03-05,Bill Sharing
40906174,11915,0,-9637921,2019-03-06,2019-03-06,Groceries
40906174,0,19556,-9618365,2019-03-07,2019-03-07,
40906174,0,444105,-9174260,2019-03-08,2019-03-08,
40906174,0,428339,-8745921,2019-03-08,2019-03-08,
40906174,337606,0,-9083527,2019-03-08,2019-03-08,Groceries
40906174,14957,0,-9098484,2019-03-09,2019-03-09,Groceries
40906174,0,10779,-9087705,2019-03-09,2019-03-09,
40906174,10285,0,-9097990,2019-03-10,2019-03-10,Transportation
40906174,0,339546,-8758444,2019-03-10,2019-03-10,
40906174,11451,0,-8769895,2019-03-11,2019-03-11,Utilities
40906174,478341,0,-9248236,2019-03-11,2019-03-11,Transportation
40906174,418303,0,-9264316,2019-03-12,2019-03-12,Education
40906174,488249,0,-9752565,2019-03-13,2019-03-13,Healthcare
40906174,436961,0,-10189526,2019-03-13,2019-03-13,Transportation
40906174,13260,0,-10202786,2019-03-13,2019-03-13,Bill Sharing
40906174,0,377981,-9824805,2019-03-14,2019-03-14,
40906174,0,12214,-9812591,2019-03-14,2019-03-14,
40906174,0,11945,-9800646,2019-03-14,2019-03-14,
40906174,0,442377,-9358269,2019-03-15,2019-03-15,
40906174,0,358909,-8999360,2019-03-16,2019-03-16,
40906174,405802,0,-9405162,2019-03-16,2019-03-16,Entertainment
40906174,0,394073,-9011089,2019-03-16,2019-03-16,
40906174,10434,0,-9021523,2019-03-17,2019-03-17,Entertainment
40906174,361043,0,-9382566,2019-03-17,2019-03-17,Entertainment
40906174,435528,0,-9818094,2019-03-17,2019-03-17,Rent
40906174,474285,0,-10292379,2019-03-18,2019-03-18,Bill Sharing
40906174,0,498236,-9794143,2019-03-18,2019-03-18,
40906174,488345,0,-10282488,2019-03-19,2019-03-19,Utilities
40906174,499990,0,-10782478,2019-03-19,2019-03-19,Education
40906174,0,399201,-10383277,2019-03-19,2019-03-19,
40906174,0,339264,-10044013,2019-03-20,2019-03-20,
40906174,0,19615,-10024398,2019-03-21,2019-03-21,
40906174,0,328702,-9695696,2019-03-21,2019-03-21,
40906174,0,333114,-9362582,2019-03-22,2019-03-22,
40906174,383666,0,-9746248,2019-03-22,2019-03-22,Rent
40906174,0,370779,-9375469,2019-03-22,2019-03-22,
40906174,441241,0,-9816710,2019-03-23,2019-03-23,Clothes
40906174,0,12212,-9804498,2019-03-24,2019-03-24,
40906174,0,415017,-9389481,2019-03-24,2019-03-24,
40906174,0,19508,-9369973,2019-03-25,2019-03-25,
40906174,0,342542,-9027431,2019-03-26,2019-03-26,
40906174,19931,0,-9047362,2019-03-26,2019-03-26,Rent
40906174,0,14024,-9033338,2019-03-26,2019-03-26,
40906174,0,628522,-9051685,2019-03-27,2019-03-27,
40906174,0,336130,-8715555,2019-03-28,2019-03-28,
40906174,0,477248,-8238307,2019-03-28,2019-03-28,
40906174,19213,0,-8257520,2019-03-29,2019-03-29,Rent
40906174,352682,0,-8610202,2019-03-29,2019-03-29,Entertainment
40906174,0,480185,-8130017,2019-03-29,2019-03-29,
40906174,0,341228,-7788789,2019-03-30,2019-03-30,
40906174,0,314769,-7474020,2019-03-30,2019-03-30,
40906174,319507,0,-7793527,2019-03-31,2019-03-31,Groceries
40906174,0,315875,-7477652,2019-03-31,2019-03-31,
40906174,0,18834,-7458818,2019-03-31,2019-03-31,
40906174,0,343639,-7115179,2019-04-01,2019-04-01,
40906174,15578,0,-7130757,2019-04-01,2019-04-01,Utilities
40906174,0,474762,-6655995,2019-04-02,2019-04-02,
40906174,0,16250,-6639745,2019-04-02,2019-04-02,
40906174,394161,0,-7033906,2019-04-03,2019-04-03,Bill Sharing
40906174,411242,0,-6653587,2019-04-04,2019-04-04,Education
40906174,0,17506,-6636081,2019-04-05,2019-04-05,
40906174,0,15789,-6620292,2019-04-06,2019-04-06,
40906174,497952,0,-7118244,2019-04-06,2019-04-06,Healthcare
40906174,389667,0,-7507911,2019-04-07,2019-04-07,Groceries
40906174,490207,0,-7998118,2019-04-07,2019-04-07,Bill Sharing
40906174,19964,0,-8018082,2019-04-08,2019-04-08,Clothes
40906174,0,10592,-8007490,2019-04-08,2019-04-08,
40906174,361719,0,-8369209,2019-04-09,2019-04-09,Education
40906174,473008,0,-8842217,2019-04-09,2019-04-09,Entertainment
40906174,374590,0,-9216807,2019-04-09,2019-04-09,Entertainment
40906174,0,302771,-8914036,2019-04-10,2019-04-10,
40906174,0,379627,-8534409,2019-04-11,2019-04-11,
40906174,0,389460,-8144949,2019-04-11,2019-04-11,
40906174,0,477536,-7667413,2019-04-11,2019-04-11,
40906174,0,14809,-7652604,2019-04-12,2019-04-12,
40906174,329449,0,-7982053,2019-04-12,2019-04-12,Clothes
40906174,17035,0,-7999088,2019-04-13,2019-04-13,Entertainment
40906174,0,18509,-7980579,2019-04-13,2019-04-13,
40906174,0,360201,-7620378,2019-04-13,2019-04-13,
40906174,14741,0,-7635119,2019-04-14,2019-04-14,Rent
40906174,0,16870,-7618249,2019-04-14,2019-04-14,
40906174,11545,0,-7629794,2019-04-14,2019-04-14,Entertainment
40906174,0,390999,-7238795,2019-04-15,2019-04-15,
40906174,0,401833,-6836962,2019-04-16,2019-04-16,
40906174,0,310657,-6526305,2019-04-16,2019-04-16,
40906174,400523,0,-6926828,2019-04-16,2019-04-16,Education
40906174,341549,0,-7268377,2019-04-17,2019-04-17,Entertainment
40906174,11933,0,-7280310,2019-04-17,2019-04-17,Rent
40906174,0,16897,-7263413,2019-04-18,2019-04-18,
40906174,354241,0,-7617654,2019-04-18,2019-04-18,Entertainment
40906174,441679,0,-8059333,2019-04-19,2019-04-19,Rent
40906174,0,415319,-7644014,2019-04-19,2019-04-19,
40906174,13738,0,-7657752,2019-04-20,2019-04-20,Utilities
40906174,0,10002,-7647750,2019-04-20,2019-04-20,
40906174,0,650426,-8074901,2019-04-20,2019-04-20,
40906174,300927,0,-8375828,2019-04-21,2019-04-21,Bill Sharing
40906174,326487,0,-8702315,2019-04-21,2019-04-21,Transportation
40906174,19371,0,-8721686,2019-04-21,2019-04-21,Healthcare
40906174,12268,0,-8733954,2019-04-22,2019-04-22,Education
40906174,0,439046,-8294908,2019-04-22,2019-04-22,
40906174,0,358115,-7936793,2019-04-22,2019-04-22,
40906174,0,360280,-7576513,2019-04-23,2019-04-23,
40906174,479428,0,-8055941,2019-04-23,2019-04-23,Entertainment
40906174,0,649756,-7719256,2019-04-24,2019-04-24,
40906174,0,11931,-7707325,2019-04-25,2019-04-25,
40906174,0,17787,-7689538,2019-04-26,2019-04-26,
40906174,13468,0,-7703006,2019-04-27,2019-04-27,Clothes
40906174,365710,0,-8068716,2019-04-27,2019-04-27,Utilities
40906174,0,320818,-7747898,2019-04-28,2019-04-28,
40906174,410199,0,-8158097,2019-04-29,2019-04-29,Utilities
40906174,18078,0,-8176175,2019-04-29,2019-04-29,Education
40906174,398236,0,-8574411,2019-04-30,2019-04-30,Education
40906174,0,300240,-8274171,2019-04-30,2019-04-30,
40906174,11122,0,-8285293,2019-05-01,2019-05-01,Groceries
40906174,356132,0,-8641425,2019-05-01,2019-05-01,Transportation
40906174,0,374126,-8267299,2019-05-01,2019-05-01,
40906174,0,17827,-8249472,2019-05-02,2019-05-02,
40906174,0,370050,-7879422,2019-05-02,2019-05-02,
40906174,0,17389,-7862033,2019-05-02,2019-05-02,
40906174,451800,0,-8313833,2019-05-03,2019-05-03,Utilities
40906174,0,10863,-8302970,2019-05-03,2019-05-03,
40906174,411168,0,-8714138,2019-05-03,2019-05-03,Education
40906174,469842,0,-9183980,2019-05-04,2019-05-04,Entertainment
40906174,12774,0,-9196754,2019-05-05,2019-05-05,Transportation
40906174,318466,0,-9515220,2019-05-05,2019-05-05,Bill Sharing
40906174,324391,0,-9839611,2019-05-05,2019-05-05,Healthcare
40906174,0,18947,-9820664,2019-05-06,2019-05-06,
40906174,0,310563,-9510101,2019-05-06,2019-05-06,
40906174,0,12427,-9497674,2019-05-06,2019-05-06,
40906174,0,430436,-9067238,2019-05-07,2019-05-07,
40906174,17635,0,-9084873,2019-05-07,2019-05-07,Utilities
40906174,0,436952,-8647921,2019-05-08,2019-05-08,
40906174,455019,0,-9102940,2019-05-08,2019-05-08,Entertainment
40906174,362932,0,-9465872,2019-05-08,2019-05-08,Rent
40906174,0,490810,-8975062,2019-05-09,2019-05-09,
40906174,372129,0,-9347191,2019-05-09,2019-05-09,Transportation
40906174,0,17798,-9329393,2019-05-09,2019-05-09,
40906174,0,416436,-8912957,2019-05-10,2019-05-10,
40906174,0,14087,-8898870,2019-05-10,2019-05-10,
40906174,462238,0,-9361108,2019-05-11,2019-05-11,Education
40906174,0,305756,-9055352,2019-05-12,2019-05-12,
40906174,310115,0,-9365467,2019-05-13,2019-05-13,Healthcare
40906174,0,471181,-8894286,2019-05-14,2019-05-14,
40906174,453640,0,-9347926,2019-05-15,2019-05-15,Clothes
40906174,12625,0,-9360551,2019-05-15,2019-05-15,Transportation
40906174,0,439545,-8921006,2019-05-16,2019-05-16,
40906174,374241,0,-9295247,2019-05-16,2019-05-16,Education
40906174,426758,0,-9722005,2019-05-16,2019-05-16,Entertainment
40906174,15820,0,-9737825,2019-05-17,2019-05-17,Transportation
40906174,14857,0,-9752682,2019-05-17,2019-05-17,Clothes
40906174,0,419565,-9333117,2019-05-18,2019-05-18,
40906174,18062,0,-9351179,2019-05-18,2019-05-18,Rent
40906174,0,14239,-9336940,2019-05-19,2019-05-19,
40906174,0,329753,-9007187,2019-05-19,2019-05-19,
40906174,491970,0,-9499157,2019-05-19,2019-05-19,Clothes
40906174,13084,0,-9512241,2019-05-20,2019-05-20,Clothes
40906174,0,10313,-9501928,2019-05-20,2019-05-20,
40906174,0,11601,-9490327,2019-05-20,2019-05-20,
40906174,0,17082,-9473245,2019-05-21,2019-05-21,
40906174,382801,0,-9856046,2019-05-21,2019-05-21,Clothes
40906174,361738,0,-10217784,2019-05-21,2019-05-21,Rent
40906174,380713,0,-10598497,2019-05-22,2019-05-22,Clothes
40906174,0,490156,-10108341,2019-05-22,2019-05-22,
40906174,12779,0,-10121120,2019-05-23,2019-05-23,Clothes
40906174,375266,0,-10496386,2019-05-23,2019-05-23,Clothes
40906174,0,761589,-10513948,2019-05-23,2019-05-23,
40906174,0,327007,-10186941,2019-05-24,2019-05-24,
40906174,0,371205,-9815736,2019-05-24,2019-05-24,
40906174,0,352656,-9463080,2019-05-25,2019-05-25,
40906174,0,10469,-9452611,2019-05-25,2019-05-25,
40906174,0,413933,-9038678,2019-05-25,2019-05-25,
40906174,0,18678,-9020000,2019-05-26,2019-05-26,
40906174,425769,0,-9445769,2019-05-26,2019-05-26,Healthcare
40906174,0,462359,-8983410,2019-05-27,2019-05-27,
40906174,0,470196,-8513214,2019-05-28,2019-05-28,
40906174,18670,0,-8531884,2019-05-28,2019-05-28,Healthcare
40906174,460063,0,-8991947,2019-05-29,2019-05-29,Clothes
40906174,0,446099,-8545848,2019-05-29,2019-05-29,
40906174,0,484184,-8061664,2019-05-30,2019-05-30,
40906174,0,12744,-8048920,2019-05-30,2019-05-30,
40906174,14758,0,-8063678,2019-05-31,2019-05-31,Rent
40906174,0,14162,-8049516,2019-06-01,2019-06-01,
40906174,0,495638,-7553878,2019-06-01,2019-06-01,
40906174,18316,0,-7572194,2019-06-01,2019-06-01,Entertainment
40906174,306558,0,-7878752,2019-06-02,2019-06-02,Rent
40906174,357365,0,-8236117,2019-06-02,2019-06-02,Clothes
40906174,405930,0,-8642047,2019-06-03,2019-06-03,Utilities
40906174,0,354439,-8287608,2019-06-03,2019-06-03,
40906174,18059,0,-8305667,2019-06-03,2019-06-03,Rent
40906174,0,442573,-7863094,2019-06-04,2019-06-04,
40906174,379554,0,-8242648,2019-06-04,2019-06-04,Clothes
40906174,416562,0,-8659210,2019-06-04,2019-06-04,Clothes
40906174,0,591184,-9003820,2019-06-05,2019-06-05,
40906174,425269,0,-9429089,2019-06-06,2019-06-06,Healthcare
40906174,398578,0,-9827667,2019-06-06,2019-06-06,Transportation
40906174,0,19993,-9807674,2019-06-06,2019-06-06,
40906174,0,12435,-9795239,2019-06-07,2019-06-07,
40906174,310688,0,-10105927,2019-06-07,2019-06-07,Clothes
40906174,0,475749,-9630178,2019-06-07,2019-06-07,
40906174,0,12283,-9617895,2019-06-08,2019-06-08,
40906174,485496,0,-10103391,2019-06-09,2019-06-09,Utilities
40906174,0,425129,-9678262,2019-06-09,2019-06-09,
40906174,0,17991,-9660271,2019-06-09,2019-06-09,
40906174,385080,0,-10045351,2019-06-10,2019-06-10,Entertainment
40906174,11241,0,-10056592,2019-06-10,2019-06-10,Transportation
40906174,441709,0,-10498301,2019-06-10,2019-06-10,Entertainment
40906174,641184,0,-10513309,2019-06-11,2019-06-11,Healthcare
40906174,0,471644,-10041665,2019-06-11,2019-06-11,
40906174,366327,0,-10407992,2019-06-11,2019-06-11,Healthcare
40906174,0,13117,-10394875,2019-06-12,2019-06-12,
40906174,0,19778,-10375097,2019-06-12,2019-06-12,
40906174,0,428551,-9946546,2019-06-12,2019-06-12,
40906174,389203,0,-10335749,2019-06-13,2019-06-13,Transportation
40906174,0,13621,-10322128,2019-06-14,2019-06-14,
40906174,16327,0,-10338455,2019-06-15,2019-06-15,Entertainment
40906174,0,331706,-10006749,2019-06-15,2019-06-15,
40906174,315734,0,-10322483,2019-06-15,2019-06-15,Healthcare
40906174,0,462608,-9859875,2019-06-16,2019-06-16,
40906174,0,330154,-9529721,2019-06-16,2019-06-16,
40906174,0,19033,-9510688,2019-06-17,2019-06-17,
40906174,0,374481,-9136207,2019-06-17,2019-06-17,
40906174,17687,0,-9153894,2019-06-17,2019-06-17,Healthcare
40906174,0,380858,-8773036,2019-06-18,2019-06-18,
40906174,761617,0,-9173390,2019-06-19,2019-06-19,Education
40906174,311595,0,-9484985,2019-06-19,2019-06-19,Education
40906174,0,447245,-9037740,2019-06-19,2019-06-19,
40906174,324553,0,-9362293,2019-06-20,2019-06-20,Groceries
40906174,19539,0,-9381832,2019-06-20,2019-06-20,Groceries
40906174,13435,0,-9395267,2019-06-21,2019-06-21,Clothes
40906174,989398,0,-9379077,2019-06-21,2019-06-21,Healthcare
40906174,309013,0,-9688090,2019-06-21,2019-06-21,Bill Sharing
40906174,379534,0,-10067624,2019-06-22,2019-06-22,Clothes
40906174,0,353278,-9714346,2019-06-22,2019-06-22,
40906174,19434,0,-9733780,2019-06-23,2019-06-23,Rent
40906174,15374,0,-9749154,2019-06-24,2019-06-24,Utilities
40906174,18629,0,-9767783,2019-06-24,2019-06-24,Utilities
40906174,438305,0,-10206088,2019-06-25,2019-06-25,Entertainment
40906174,333190,0,-10539278,2019-06-26,2019-06-26,Entertainment
40906174,0,357482,-10181796,2019-06-26,2019-06-26,
40906174,13231,0,-10195027,2019-06-27,2019-06-27,Utilities
40906174,0,14281,-10180746,2019-06-27,2019-06-27,
40906174,0,470337,-9710409,2019-06-28,2019-06-28,
40906174,0,10949,-9699460,2019-06-28,2019-06-28,
40906174,0,447253,-9252207,2019-06-28,2019-06-28,
40906174,0,458316,-8793891,2019-06-29,2019-06-29,
40906174,0,427788,-8366103,2019-06-30,2019-06-30,
40906174,0,418382,-7947721,2019-07-01,2019-07-01,
40906174,0,331622,-7616099,2019-07-02,2019-07-02,
40906174,404188,0,-8020287,2019-07-02,2019-07-02,Education
40906174,388359,0,-8408646,2019-07-03,2019-07-03,Entertainment
40906174,18419,0,-8427065,2019-07-03,2019-07-03,Bill Sharing
40906174,0,337505,-8089560,2019-07-03,2019-07-03,
40906174,0,13086,-8076474,2019-07-04,2019-07-04,
40906174,0,369987,-7706487,2019-07-04,2019-07-04,
40906174,0,342698,-7363789,2019-07-05,2019-07-05,
40906174,0,427168,-6936621,2019-07-05,2019-07-05,
40906174,0,10155,-6926466,2019-07-06,2019-07-06,
40906174,0,489068,-6941682,2019-07-06,2019-07-06,
40906174,483778,0,-7425460,2019-07-07,2019-07-07,Entertainment
40906174,346564,0,-7772024,2019-07-08,2019-07-08,Education
40906174,0,345550,-7426474,2019-07-08,2019-07-08,
40906174,318630,0,-7745104,2019-07-08,2019-07-08,Education
40906174,667539,0,-8188311,2019-07-09,2019-07-09,Education
40906174,0,370912,-7817399,2019-07-09,2019-07-09,
40906174,0,17542,-7799857,2019-07-09,2019-07-09,
40906174,0,454054,-7345803,2019-07-10,2019-07-10,
40906174,354995,0,-7700798,2019-07-10,2019-07-10,Clothes
40906174,470851,0,-8171649,2019-07-11,2019-07-11,Education
40906174,0,362443,-7809206,2019-07-11,2019-07-11,
40906174,0,407763,-7401443,2019-07-12,2019-07-12,
40906174,0,436238,-6965205,2019-07-13,2019-07-13,
40906174,0,13106,-6952099,2019-07-13,2019-07-13,
40906174,450395,0,-7402494,2019-07-13,2019-07-13,Rent
40906174,0,448065,-7753055,2019-07-14,2019-07-14,
40906174,0,463445,-7289610,2019-07-14,2019-07-14,
40906174,0,322605,-6967005,2019-07-15,2019-07-15,
40906174,17735,0,-6984740,2019-07-16,2019-07-16,Rent
40906174,0,474720,-6510020,2019-07-16,2019-07-16,
40906174,301837,0,-6811857,2019-07-16,2019-07-16,Healthcare
40906174,352888,0,-7164745,2019-07-17,2019-07-17,Bill Sharing
40906174,0,413356,-6751389,2019-07-17,2019-07-17,
40906174,450031,0,-7201420,2019-07-18,2019-07-18,Utilities
40906174,17389,0,-7218809,2019-07-19,2019-07-19,Clothes
40906174,350729,0,-7569538,2019-07-19,2019-07-19,Clothes
40906174,0,454403,-7115135,2019-07-19,2019-07-19,
40906174,339200,0,-7454335,2019-07-20,2019-07-20,Groceries
40906174,353981,0,-7808316,2019-07-20,2019-07-20,Education
40906174,0,498661,-7309655,2019-07-21,2019-07-21,
40906174,0,472358,-6837297,2019-07-21,2019-07-21,
40906174,16502,0,-6853799,2019-07-21,2019-07-21,Healthcare
40906174,426859,0,-7280658,2019-07-22,2019-07-22,Transportation
40906174,0,974635,-7707121,2019-07-22,2019-07-22,
40906174,0,456568,-7250553,2019-07-23,2019-07-23,
40906174,0,12197,-7238356,2019-07-24,2019-07-24,
40906174,0,13713,-7224643,2019-07-24,2019-07-24,
40906174,344625,0,-7569268,2019-07-25,2019-07-25,Bill Sharing
40906174,13019,0,-7582287,2019-07-25,2019-07-25,Bill Sharing
40906174,319448,0,-7901735,2019-07-26,2019-07-26,Education
40906174,0,492447,-7409288,2019-07-26,2019-07-26,
40906174,0,378285,-7031003,2019-07-27,2019-07-27,
40906174,316063,0,-7347066,2019-07-28,2019-07-28,Entertainment
40906174,0,19010,-7328056,2019-07-28,2019-07-28,
40906174,16230,0,-7344286,2019-07-28,2019-07-28,Rent
40906174,0,18288,-7325998,2019-07-29,2019-07-29,
40906174,0,384702,-6941296,2019-07-30,2019-07-30,
40906174,12981,0,-6954277,2019-07-31,2019-07-31,Education
40906174,0,579846,-7345159,2019-07-31,2019-07-31,
40906174,17660,0,-7362819,2019-08-01,2019-08-01,Bill Sharing
40906174,479732,0,-7842551,2019-08-02,2019-08-02,Healthcare
40906174,302485,0,-8145036,2019-08-02,2019-08-02,Utilities
40906174,0,429119,-7715917,2019-08-02,2019-08-02,
40906174,0,417369,-7298548,2019-08-03,2019-08-03,
40906174,0,458404,-6840144,2019-08-03,2019-08-03,
40906174,0,456277,-6383867,2019-08-03,2019-08-03,
40906174,0,14421,-6369446,2019-08-04,2019-08-04,
40906174,0,413343,-5956103,2019-08-05,2019-08-05,
40906174,0,18587,-5937516,2019-08-06,2019-08-06,
40906174,361787,0,-6299303,2019-08-06,2019-08-06,Transportation
40906174,421933,0,-6721236,2019-08-06,2019-08-06,Bill Sharing
40906174,431339,0,-7152575,2019-08-07,2019-08-07,Groceries
40906174,0,407551,-6745024,2019-08-07,2019-08-07,
40906174,0,330739,-6414285,2019-08-07,2019-08-07,
40906174,17280,0,-6431565,2019-08-08,2019-08-08,Entertainment
40906174,0,391310,-6040255,2019-08-09,2019-08-09,
40906174,385801,0,-6426056,2019-08-09,2019-08-09,Rent
40906174,337958,0,-6764014,2019-08-10,2019-08-10,Rent
40906174,429378,0,-7193392,2019-08-11,2019-08-11,Clothes
40906174,478401,0,-7671793,2019-08-11,2019-08-11,Groceries
40906174,0,417105,-7254688,2019-08-12,2019-08-12,
40906174,12127,0,-7266815,2019-08-12,2019-08-12,Bill Sharing
40906174,451465,0,-7718280,2019-08-12,2019-08-12,Entertainment
40906174,0,15249,-7703031,2019-08-13,2019-08-13,
40906174,979880,0,-8116399,2019-08-13,2019-08-13,Education
40906174,482919,0,-8599318,2019-08-13,2019-08-13,Clothes
40906174,481661,0,-9080979,2019-08-14,2019-08-14,Utilities
40906174,0,18425,-9062554,2019-08-14,2019-08-14,
40906174,0,466207,-8596347,2019-08-15,2019-08-15,
40906174,365989,0,-8962336,2019-08-15,2019-08-15,Bill Sharing
40906174,0,451052,-8511284,2019-08-15,2019-08-15,
40906174,0,453843,-8057441,2019-08-16,2019-08-16,
40906174,0,15788,-8041653,2019-08-16,2019-08-16,
40906174,0,474042,-7567611,2019-08-17,2019-08-17,
40906174,478695,0,-8046306,2019-08-18,2019-08-18,Entertainment
40906174,0,464290,-7582016,2019-08-18,2019-08-18,
40906174,454069,0,-8036085,2019-08-19,2019-08-19,Education
40906174,0,444594,-7591491,2019-08-19,2019-08-19,
40906174,19367,0,-7610858,2019-08-20,2019-08-20,Healthcare
40906174,10497,0,-7621355,2019-08-20,2019-08-20,Transportation
40906174,456516,0,-8077871,2019-08-20,2019-08-20,Utilities
40906174,0,15694,-8062177,2019-08-21,2019-08-21,
40906174,486028,0,-8548205,2019-08-21,2019-08-21,Transportation
40906174,0,18055,-8530150,2019-08-22,2019-08-22,
40906174,15356,0,-8545506,2019-08-22,2019-08-22,Groceries
40906174,10208,0,-8555714,2019-08-23,2019-08-23,Entertainment
40906174,0,820365,-8570745,2019-08-24,2019-08-24,
40906174,369160,0,-8939905,2019-08-24,2019-08-24,Rent
40906174,319677,0,-9259582,2019-08-25,2019-08-25,Bill Sharing
40906174,0,14087,-9245495,2019-08-25,2019-08-25,
40906174,408848,0,-9654343,2019-08-26,2019-08-26,Rent
40906174,0,13256,-9641087,2019-08-26,2019-08-26,
40906174,0,404970,-9236117,2019-08-26,2019-08-26,
40906174,399538,0,-9635655,2019-08-27,2019-08-27,Healthcare
40906174,0,19948,-9615707,2019-08-28,2019-08-28,
40906174,0,384560,-9231147,2019-08-28,2019-08-28,
40906174,18537,0,-9249684,2019-08-29,2019-08-29,Healthcare
40906174,18376,0,-9268060,2019-08-29,2019-08-29,Bill Sharing
40906174,0,399648,-8868412,2019-08-30,2019-08-30,
40906174,436486,0,-9304898,2019-08-30,2019-08-30,Utilities
40906174,0,13583,-9291315,2019-08-30,2019-08-30,
40906174,381320,0,-9672635,2019-08-31,2019-08-31,Groceries
40906174,0,11759,-9660876,2019-08-31,2019-08-31,
40906174,734207,0,-9672447,2019-08-31,2019-08-31,Education
40906174,0,11024,-9661423,2019-09-01,2019-09-01,
40906174,0,478426,-9182997,2019-09-01,2019-09-01,
40906174,430573,0,-9613570,2019-09-01,2019-09-01,Healthcare
40906174,15184,0,-9628754,2019-09-02,2019-09-02,Entertainment
40906174,0,14100,-9614654,2019-09-02,2019-09-02,
40906174,385737,0,-10000391,2019-09-03,2019-09-03,Transportation
40906174,0,431469,-9568922,2019-09-04,2019-09-04,
40906174,0,317751,-9251171,2019-09-04,2019-09-04,
40906174,18073,0,-9269244,2019-09-05,2019-09-05,Entertainment
40906174,314958,0,-9584202,2019-09-05,2019-09-05,Education
40906174,316979,0,-9901181,2019-09-05,2019-09-05,Rent
40906174,0,383812,-9517369,2019-09-06,2019-09-06,
40906174,0,351515,-9165854,2019-09-07,2019-09-07,
40906174,0,396057,-8769797,2019-09-07,2019-09-07,
40906174,351262,0,-9121059,2019-09-08,2019-09-08,Education
40906174,318764,0,-9439823,2019-09-08,2019-09-08,Utilities
40906174,0,11536,-9428287,2019-09-09,2019-09-09,
40906174,376598,0,-9804885,2019-09-09,2019-09-09,Clothes
40906174,0,477270,-9327615,2019-09-09,2019-09-09,
40906174,0,10879,-9316736,2019-09-10,2019-09-10,
40906174,0,448322,-9333066,2019-09-11,2019-09-11,
40906174,19116,0,-9352182,2019-09-11,2019-09-11,Healthcare
40906174,360784,0,-9712966,2019-09-12,2019-09-12,Clothes
40906174,14745,0,-9727711,2019-09-13,2019-09-13,Groceries
40906174,0,18823,-9708888,2019-09-13,2019-09-13,
40906174,0,332920,-9375968,2019-09-14,2019-09-14,
40906174,0,495234,-8880734,2019-09-15,2019-09-15,
40906174,0,475401,-8405333,2019-09-15,2019-09-15,
40906174,0,11190,-8394143,2019-09-15,2019-09-15,
40906174,0,12035,-8382108,2019-09-16,2019-09-16,
40906174,0,365152,-8016956,2019-09-17,2019-09-17,
40906174,399337,0,-8416293,2019-09-17,2019-09-17,Education
40906174,0,473006,-7943287,2019-09-17,2019-09-17,
40906174,0,11767,-7931520,2019-09-18,2019-09-18,
40906174,0,328015,-7603505,2019-09-18,2019-09-18,
40906174,0,18680,-7584825,2019-09-18,2019-09-18,
40906174,473912,0,-8058737,2019-09-19,2019-09-19,Bill Sharing
40906174,423119,0,-8481856,2019-09-20,2019-09-20,Entertainment
40906174,15254,0,-8497110,2019-09-21,2019-09-21,Bill Sharing
40906174,0,386632,-8110478,2019-09-21,2019-09-21,
40906174,0,15980,-8094498,2019-09-21,2019-09-21,
40906174,340526,0,-8435024,2019-09-22,2019-09-22,Transportation
40906174,0,11736,-8423288,2019-09-23,2019-09-23,
40906174,0,426643,-7996645,2019-09-23,2019-09-23,
40906174,0,11769,-7984876,2019-09-24,2019-09-24,
40906174,405523,0,-8390399,2019-09-25,2019-09-25,Clothes
40906174,13026,0,-8403425,2019-09-25,2019-09-25,Utilities
40906174,15923,0,-8419348,2019-09-26,2019-09-26,Groceries
40906174,0,329654,-8089694,2019-09-26,2019-09-26,
40906174,0,454776,-7634918,2019-09-26,2019-09-26,
40906174,786777,0,-7615714,2019-09-27,2019-09-27,Healthcare
40906174,0,315884,-7299830,2019-09-27,2019-09-27,
40906174,476463,0,-7776293,2019-09-28,2019-09-28,Groceries
40906174,15396,0,-7791689,2019-09-28,2019-09-28,Bill Sharing
40906174,479804,0,-8103296,2019-09-28,2019-09-28,Education
40906174,0,19596,-8083700,2019-09-29,2019-09-29,
40906174,0,13523,-8070177,2019-09-30,2019-09-30,
40906174,329641,0,-8399818,2019-09-30,2019-09-30,Clothes
40906174,0,430287,-7969531,2019-10-01,2019-10-01,
40906174,0,443341,-7526190,2019-10-01,2019-10-01,
40906174,382351,0,-7908541,2019-10-02,2019-10-02,Rent
40906174,17428,0,-7925969,2019-10-03,2019-10-03,Rent
40906174,19028,0,-7944997,2019-10-04,2019-10-04,Groceries
40906174,0,470995,-7474002,2019-10-04,2019-10-04,
40906174,310401,0,-7784403,2019-10-04,2019-10-04,Rent
40906174,0,419053,-7365350,2019-10-05,2019-10-05,
40906174,17639,0,-7382989,2019-10-05,2019-10-05,Transportation
40906174,426564,0,-7809553,2019-10-05,2019-10-05,Transportation
40906174,0,406139,-7403414,2019-10-06,2019-10-06,
40906174,424878,0,-7828292,2019-10-06,2019-10-06,Entertainment
40906174,0,778827,-8315162,2019-10-06,2019-10-06,
40906174,0,842094,-8333527,2019-10-07,2019-10-07,
40906174,12086,0,-8345613,2019-10-07,2019-10-07,Education
40906174,0,18641,-8326972,2019-10-07,2019-10-07,
40906174,12606,0,-8339578,2019-10-08,2019-10-08,Groceries
40906174,17510,0,-8357088,2019-10-09,2019-10-09,Education
40906174,0,18767,-8338321,2019-10-09,2019-10-09,
40906174,13137,0,-8351458,2019-10-10,2019-10-10,Clothes
40906174,0,381794,-7969664,2019-10-10,2019-10-10,
40906174,0,417063,-7552601,2019-10-10,2019-10-10,
40906174,0,14181,-7538420,2019-10-11,2019-10-11,
40906174,0,11499,-7526921,2019-10-11,2019-10-11,
40906174,11125,0,-7538046,2019-10-12,2019-10-12,Rent
40906174,0,18714,-7519332,2019-10-12,2019-10-12,
40906174,0,19025,-7500307,2019-10-12,2019-10-12,
40906174,333112,0,-7833419,2019-10-13,2019-10-13,Groceries
40906174,0,336775,-7496644,2019-10-13,2019-10-13,
40906174,420318,0,-7916962,2019-10-13,2019-10-13,Education
40906174,0,312967,-7603995,2019-10-14,2019-10-14,
40906174,0,430785,-7173210,2019-10-15,2019-10-15,
40906174,16307,0,-7189517,2019-10-15,2019-10-15,Groceries
40906174,11270,0,-7200787,2019-10-15,2019-10-15,Healthcare
40906174,0,12350,-7188437,2019-10-16,2019-10-16,
40906174,17258,0,-7205695,2019-10-16,2019-10-16,Bill Sharing
40906174,322562,0,-7528257,2019-10-17,2019-10-17,Utilities
40906174,0,409943,-7118314,2019-10-17,2019-10-17,
40906174,19423,0,-7137737,2019-10-17,2019-10-17,Clothes
40906174,0,18860,-7118877,2019-10-18,2019-10-18,
40906174,471301,0,-7590178,2019-10-18,2019-10-18,Bill Sharing
40906174,391698,0,-7981876,2019-10-19,2019-10-19,Entertainment
40906174,326746,0,-8308622,2019-10-19,2019-10-19,Transportation
40906174,0,425178,-7883444,2019-10-19,2019-10-19,
40906174,0,455021,-7428423,2019-10-20,2019-10-20,
40906174,0,425293,-7003130,2019-10-20,2019-10-20,
40906174,17798,0,-7020928,2019-10-21,2019-10-21,Healthcare
40906174,498573,0,-7519501,2019-10-22,2019-10-22,Healthcare
40906174,0,312530,-7206971,2019-10-22,2019-10-22,
40906174,478688,0,-7685659,2019-10-23,2019-10-23,Education
40906174,475636,0,-8161295,2019-10-23,2019-10-23,Clothes
40906174,0,458140,-7703155,2019-10-23,2019-10-23,
40906174,17593,0,-7720748,2019-10-24,2019-10-24,Education
40906174,0,350907,-7369841,2019-10-25,2019-10-25,
40906174,0,357585,-7012256,2019-10-25,2019-10-25,
40906174,0,361593,-6650663,2019-10-26,2019-10-26,
40906174,315679,0,-6966342,2019-10-27,2019-10-27,Rent
40906174,18453,0,-6984795,2019-10-27,2019-10-27,Utilities
40906174,487237,0,-7472032,2019-10-27,2019-10-27,Clothes
40906174,0,474548,-6997484,2019-10-28,2019-10-28,
40906174,0,19167,-6978317,2019-10-29,2019-10-29,
40906174,0,476960,-6501357,2019-10-30,2019-10-30,
40906174,0,396099,-6105258,2019-10-30,2019-10-30,
40906174,443467,0,-6548725,2019-10-31,2019-10-31,Healthcare
40906174,481595,0,-7030320,2019-10-31,2019-10-31,Transportation
40906174,0,411265,-6619055,2019-11-01,2019-11-01,
40906174,0,19341,-6599714,2019-11-02,2019-11-02,
40906174,0,405926,-6193788,2019-11-03,2019-11-03,
40906174,0,449069,-5744719,2019-11-03,2019-11-03,
40906174,0,10712,-5734007,2019-11-04,2019-11-04,
40906174,0,19651,-5714356,2019-11-05,2019-11-05,
40906174,0,452120,-5262236,2019-11-06,2019-11-06,
40906174,0,320100,-4942136,2019-11-07,2019-11-07,
40906174,0,18544,-4923592,2019-11-07,2019-11-07,
40906174,0,10138,-4913454,2019-11-07,2019-11-07,
40906174,0,695321,-4900774,2019-11-08,2019-11-08,
40906174,0,11970,-4888804,2019-11-08,2019-11-08,
40906174,365610,0,-5254414,2019-11-09,2019-11-09,Healthcare
40906174,12476,0,-5266890,2019-11-09,2019-11-09,Bill Sharing
40906174,0,474440,-4792450,2019-11-10,2019-11-10,
40906174,17455,0,-4809905,2019-11-10,2019-11-10,Bill Sharing
40906174,0,433639,-4376266,2019-11-10,2019-11-10,
40906174,302547,0,-4678813,2019-11-11,2019-11-11,Bill Sharing
40906174,470768,0,-5149581,2019-11-11,2019-11-11,Rent
40906174,325504,0,-5475085,2019-11-12,2019-11-12,Entertainment
40906174,421397,0,-5896482,2019-11-12,2019-11-12,Transportation
40906174,0,444432,-5452050,2019-11-12,2019-11-12,
40906174,349469,0,-5801519,2019-11-13,2019-11-13,Entertainment
40906174,0,18762,-5782757,2019-11-13,2019-11-13,
40906174,483552,0,-6266309,2019-11-13,2019-11-13,Healthcare
40906174,0,462738,-5803571,2019-11-14,2019-11-14,
40906174,357075,0,-6160646,2019-11-14,2019-11-14,Clothes
40906174,324904,0,-6485550,2019-11-14,2019-11-14,Education
40906174,0,393828,-6091722,2019-11-15,2019-11-15,
40906174,0,464559,-5627163,2019-11-15,2019-11-15,
40906174,0,322904,-5304259,2019-11-16,2019-11-16,
40906174,0,315528,-4988731,2019-11-17,2019-11-17,
40906174,382256,0,-5370987,2019-11-18,2019-11-18,Transportation
40906174,534260,0,-5766335,2019-11-19,2019-11-19,Healthcare
40906174,0,308031,-5458304,2019-11-19,2019-11-19,
40906174,0,476462,-4981842,2019-11-20,2019-11-20,
40906174,458706,0,-5440548,2019-11-20,2019-11-20,Utilities
40906174,484199,0,-5924747,2019-11-20,2019-11-20,Education
40906174,0,362159,-5562588,2019-11-21,2019-11-21,
40906174,0,18051,-5544537,2019-11-21,2019-11-21,
40906174,0,12105,-5532432,2019-11-21,2019-11-21,
40906174,0,340566,-5191866,2019-11-22,2019-11-22,
40906174,0,12006,-5179860,2019-11-22,2019-11-22,
40906174,12021,0,-5191881,2019-11-22,2019-11-22,Groceries
40906174,0,18575,-5173306,2019-11-23,2019-11-23,
40906174,12049,0,-5185355,2019-11-23,2019-11-23,Clothes
40906174,432824,0,-5618179,2019-11-23,2019-11-23,Healthcare
40906174,0,14320,-5603859,2019-11-24,2019-11-24,
40906174,0,393930,-5209929,2019-11-24,2019-11-24,
40906174,0,429818,-4780111,2019-11-25,2019-11-25,
40906174,0,331179,-4448932,2019-11-26,2019-11-26,
40906174,0,15469,-4433463,2019-11-26,2019-11-26,
40906174,0,14222,-4419241,2019-11-26,2019-11-26,
40906174,0,16718,-4402523,2019-11-27,2019-11-27,
40906174,440509,0,-4843032,2019-11-28,2019-11-28,Utilities
40906174,0,399309,-4443723,2019-11-29,2019-11-29,
40906174,373312,0,-4817035,2019-11-29,2019-11-29,Healthcare
40906174,0,442732,-4374303,2019-11-30,2019-11-30,
40906174,0,485358,-3888945,2019-11-30,2019-11-30,
40906174,0,17932,-3871013,2019-11-30,2019-11-30,
40906174,17264,0,-3888277,2019-12-01,2019-12-01,Utilities
40906174,448157,0,-4336434,2019-12-01,2019-12-01,Transportation
40906174,19408,0,-4355842,2019-12-02,2019-12-02,Transportation
40906174,0,477349,-3878493,2019-12-02,2019-12-02,
40906174,414795,0,-4293288,2019-12-02,2019-12-02,Bill Sharing
40906174,0,392286,-3901002,2019-12-03,2019-12-03,
40906174,0,371864,-3529138,2019-12-03,2019-12-03,
40906174,482284,0,-4011422,2019-12-03,2019-12-03,Healthcare
40906174,17630,0,-4029052,2019-12-04,2019-12-04,Rent
40906174,435500,0,-4464552,2019-12-05,2019-12-05,Rent
40906174,406926,0,-4871478,2019-12-05,2019-12-05,Rent
40906174,11921,0,-4883399,2019-12-05,2019-12-05,Clothes
40906174,0,335319,-4548080,2019-12-06,2019-12-06,
40906174,463649,0,-5011729,2019-12-06,2019-12-06,Groceries
40906174,0,579176,-5022609,2019-12-07,2019-12-07,
40906174,0,307604,-4715005,2019-12-07,2019-12-07,
40906174,414282,0,-5129287,2019-12-07,2019-12-07,Utilities
40906174,0,345313,-4783974,2019-12-08,2019-12-08,
40906174,0,18018,-4765956,2019-12-09,2019-12-09,
40906174,0,13756,-4752200,2019-12-09,2019-12-09,
40906174,0,13871,-4738329,2019-12-10,2019-12-10,
40906174,367508,0,-5105837,2019-12-10,2019-12-10,Bill Sharing
40906174,0,12288,-5093549,2019-12-11,2019-12-11,
40906174,0,362045,-4731504,2019-12-11,2019-12-11,
40906174,313433,0,-5044937,2019-12-12,2019-12-12,Clothes
40906174,0,442242,-4602695,2019-12-13,2019-12-13,
40906174,0,19608,-4583087,2019-12-14,2019-12-14,
40906174,0,17527,-4565560,2019-12-14,2019-12-14,
40906174,0,451008,-4114552,2019-12-14,2019-12-14,
40906174,16435,0,-4130987,2019-12-15,2019-12-15,Entertainment
40906174,343709,0,-4474696,2019-12-15,2019-12-15,Clothes
40906174,13529,0,-4488225,2019-12-15,2019-12-15,Clothes
40906174,492061,0,-4980286,2019-12-16,2019-12-16,Education
40906174,0,17632,-4962654,2019-12-16,2019-12-16,
40906174,16026,0,-4978680,2019-12-17,2019-12-17,Rent
40906174,437476,0,-5416156,2019-12-17,2019-12-17,Rent
40906174,0,465291,-4950865,2019-12-17,2019-12-17,
40906174,0,368991,-4581874,2019-12-18,2019-12-18,
40906174,0,17926,-4563948,2019-12-18,2019-12-18,
40906174,478019,0,-5041967,2019-12-18,2019-12-18,Clothes
40906174,324313,0,-5366280,2019-12-19,2019-12-19,Utilities
40906174,0,10541,-5355739,2019-12-20,2019-12-20,
40906174,0,445143,-4910596,2019-12-20,2019-12-20,
40906174,0,359120,-4551476,2019-12-20,2019-12-20,
40906174,12472,0,-4563948,2019-12-21,2019-12-21,Entertainment
40906174,0,17867,-4546081,2019-12-21,2019-12-21,
40906174,0,335462,-4210619,2019-12-21,2019-12-21,
40906174,0,10955,-4199664,2019-12-22,2019-12-22,
40906174,0,344479,-3855185,2019-12-22,2019-12-22,
40906174,10468,0,-3865653,2019-12-22,2019-12-22,Transportation
40906174,0,12956,-3852697,2019-12-23,2019-12-23,
40906174,16060,0,-3868757,2019-12-24,2019-12-24,Utilities
40906174,0,442358,-3426399,2019-12-24,2019-12-24,
40906174,0,347891,-3078508,2019-12-25,2019-12-25,
40906174,18009,0,-3096517,2019-12-25,2019-12-25,Healthcare
40906174,395405,0,-3491922,2019-12-26,2019-12-26,Education
40906174,0,15250,-3476672,2019-12-26,2019-12-26,
40906174,361503,0,-3838175,2019-12-26,2019-12-26,Rent
40906174,0,14793,-3823382,2019-12-27,2019-12-27,
40906174,0,315502,-3507880,2019-12-28,2019-12-28,
40906174,0,431251,-3076629,2019-12-28,2019-12-28,
40906174,17221,0,-3093850,2019-12-28,2019-12-28,Healthcare
40906174,0,10696,-3083154,2019-12-29,2019-12-29,
40906174,0,490525,-2592629,2019-12-29,2019-12-29,
40906174,438642,0,-3031271,2019-12-29,2019-12-29,Clothes
40906174,13128,0,-3044399,2019-12-30,2019-12-30,Transportation
40906174,0,433819,-2610580,2019-12-30,2019-12-30,
40906174,18990,0,-2629570,2019-12-31,2019-12-31,Rent
40906174,19413,0,-2648983,2020-01-01,2020-01-01,Entertainment
40906174,489911,0,-3138894,2020-01-01,2020-01-01,Bill Sharing
40906174,475167,0,-3614061,2020-01-01,2020-01-01,Transportation
40906174,0,408131,-3205930,2020-01-02,2020-01-02,
40906174,591092,0,-3225847,2020-01-03,2020-01-03,Healthcare
40906174,17213,0,-3243060,2020-01-03,2020-01-03,Entertainment
40906174,361482,0,-3604542,2020-01-03,2020-01-03,Transportation
40906174,16087,0,-3620629,2020-01-04,2020-01-04,Utilities
40906174,11551,0,-3632180,2020-01-04,2020-01-04,Clothes
40906174,15446,0,-3647626,2020-01-04,2020-01-04,Education
40906174,18601,0,-3666227,2020-01-05,2020-01-05,Healthcare
40906174,0,12680,-3653547,2020-01-05,2020-01-05,
40906174,11345,0,-3664892,2020-01-05,2020-01-05,Clothes
40906174,448746,0,-4113638,2020-01-06,2020-01-06,Bill Sharing
40906174,494483,0,-4608121,2020-01-06,2020-01-06,Transportation
40906174,0,386416,-4221705,2020-01-06,2020-01-06,
40906174,10393,0,-4232098,2020-01-07,2020-01-07,Entertainment
40906174,0,10466,-4221632,2020-01-08,2020-01-08,
40906174,0,13307,-4208325,2020-01-09,2020-01-09,
40906174,0,16780,-4191545,2020-01-10,2020-01-10,
40906174,0,323489,-3868056,2020-01-10,2020-01-10,
40906174,0,474290,-3393766,2020-01-10,2020-01-10,
40906174,0,494069,-2899697,2020-01-11,2020-01-11,
40906174,0,396839,-2502858,2020-01-11,2020-01-11,
40906174,0,482825,-2020033,2020-01-11,2020-01-11,
40906174,420301,0,-2440334,2020-01-12,2020-01-12,Rent
40906174,0,415800,-2024534,2020-01-12,2020-01-12,
40906174,0,404588,-1619946,2020-01-12,2020-01-12,
40906174,0,484032,-1135914,2020-01-13,2020-01-13,
40906174,19255,0,-1155169,2020-01-13,2020-01-13,Utilities
40906174,449916,0,-1605085,2020-01-13,2020-01-13,Clothes
40906174,495251,0,-2100336,2020-01-14,2020-01-14,Education
40906174,450544,0,-2550880,2020-01-14,2020-01-14,Utilities
40906174,14508,0,-2565388,2020-01-14,2020-01-14,Groceries
40906174,430892,0,-2996280,2020-01-15,2020-01-15,Education
40906174,18031,0,-3014311,2020-01-15,2020-01-15,Entertainment
40906174,0,15393,-2998918,2020-01-15,2020-01-15,
40906174,10634,0,-3009552,2020-01-16,2020-01-16,Healthcare
40906174,0,447867,-2561685,2020-01-17,2020-01-17,
40906174,0,17591,-2544094,2020-01-17,2020-01-17,
40906174,0,311767,-2232327,2020-01-18,2020-01-18,
40906174,483498,0,-2715825,2020-01-18,2020-01-18,Groceries
40906174,0,438893,-2276932,2020-01-19,2020-01-19,
40906174,422470,0,-2699402,2020-01-20,2020-01-20,Healthcare
40906174,0,419617,-2279785,2020-01-21,2020-01-21,
40906174,382501,0,-2662286,2020-01-21,2020-01-21,Bill Sharing
40906174,445302,0,-3107588,2020-01-22,2020-01-22,Healthcare
40906174,0,13881,-3093707,2020-01-23,2020-01-23,
40906174,0,404145,-2689562,2020-01-23,2020-01-23,
40906174,338405,0,-3027967,2020-01-24,2020-01-24,Clothes
40906174,15566,0,-3043533,2020-01-25,2020-01-25,Entertainment
40906174,0,12141,-3031392,2020-01-25,2020-01-25,
40906174,416862,0,-3448254,2020-01-25,2020-01-25,Entertainment
40906174,0,19493,-3428761,2020-01-26,2020-01-26,
40906174,0,349439,-3079322,2020-01-26,2020-01-26,
40906174,0,16163,-3063159,2020-01-27,2020-01-27,
40906174,13100,0,-3076259,2020-01-28,2020-01-28,Healthcare
40906174,463154,0,-3539413,2020-01-28,2020-01-28,Bill Sharing
40906174,366570,0,-3905983,2020-01-28,2020-01-28,Rent
40906174,0,311262,-3594721,2020-01-29,2020-01-29,
40906174,18932,0,-3613653,2020-01-29,2020-01-29,Transportation
40906174,16944,0,-3630597,2020-01-29,2020-01-29,Transportation
40906174,15678,0,-3646275,2020-01-30,2020-01-30,Entertainment
40906174,15594,0,-3661869,2020-01-31,2020-01-31,Bill Sharing
40906174,0,15778,-3646091,2020-01-31,2020-01-31,
40906174,0,441164,-3204927,2020-02-01,2020-02-01,
40906174,366076,0,-3571003,2020-02-01,2020-02-01,Utilities
40906174,0,401755,-3169248,2020-02-01,2020-02-01,
40906174,0,13309,-3155939,2020-02-02,2020-02-02,
40906174,0,493122,-2662817,2020-02-03,2020-02-03,
40906174,0,330244,-2332573,2020-02-04,2020-02-04,
40906174,0,17899,-2314674,2020-02-04,2020-02-04,
40906174,0,13570,-2301104,2020-02-05,2020-02-05,
40906174,476397,0,-2777501,2020-02-05,2020-02-05,Utilities
40906174,19967,0,-2797468,2020-02-05,2020-02-05,Education
40906174,0,15763,-2781705,2020-02-06,2020-02-06,
40906174,0,383571,-2398134,2020-02-06,2020-02-06,
40906174,309542,0,-2707676,2020-02-06,2020-02-06,Bill Sharing
40906174,0,18062,-2689614,2020-02-07,2020-02-07,
40906174,326572,0,-3016186,2020-02-07,2020-02-07,Entertainment
40906174,447279,0,-3463465,2020-02-08,2020-02-08,Entertainment
40906174,0,669355,-3449969,2020-02-08,2020-02-08,
40906174,356726,0,-3806695,2020-02-08,2020-02-08,Transportation
40906174,476465,0,-4283160,2020-02-09,2020-02-09,Education
40906174,372107,0,-4655267,2020-02-09,2020-02-09,Rent
40906174,0,14141,-4641126,2020-02-09,2020-02-09,
40906174,418756,0,-5059882,2020-02-10,2020-02-10,Rent
40906174,484105,0,-5543987,2020-02-10,2020-02-10,Clothes
40906174,329580,0,-5873567,2020-02-11,2020-02-11,Education
40906174,402501,0,-6276068,2020-02-12,2020-02-12,Groceries
40906174,306095,0,-6582163,2020-02-13,2020-02-13,Entertainment
40906174,0,311164,-6270999,2020-02-13,2020-02-13,
40906174,0,15231,-6255768,2020-02-14,2020-02-14,
40906174,342716,0,-6598484,2020-02-15,2020-02-15,Bill Sharing
40906174,351653,0,-6950137,2020-02-15,2020-02-15,Clothes
40906174,0,442960,-6507177,2020-02-15,2020-02-15,
40906174,0,400063,-6107114,2020-02-16,2020-02-16,
40906174,0,15530,-6091584,2020-02-16,2020-02-16,
40906174,11316,0,-6102900,2020-02-17,2020-02-17,Healthcare
40906174,418836,0,-6521736,2020-02-17,2020-02-17,Utilities
40906174,15460,0,-6537196,2020-02-17,2020-02-17,Clothes
40906174,16408,0,-6553604,2020-02-18,2020-02-18,Transportation
40906174,11261,0,-6564865,2020-02-19,2020-02-19,Entertainment
40906174,0,403830,-6161035,2020-02-19,2020-02-19,
40906174,378448,0,-6539483,2020-02-20,2020-02-20,Clothes
40906174,427068,0,-6966551,2020-02-20,2020-02-20,Utilities
40906174,0,17644,-6948907,2020-02-20,2020-02-20,
40906174,19496,0,-6968403,2020-02-21,2020-02-21,Clothes
40906174,405289,0,-7373692,2020-02-22,2020-02-22,Education
40906174,0,19657,-7354035,2020-02-22,2020-02-22,
40906174,0,379778,-6974257,2020-02-23,2020-02-23,
40906174,0,12246,-6962011,2020-02-23,2020-02-23,
40906174,0,446283,-6515728,2020-02-23,2020-02-23,
40906174,11939,0,-6527667,2020-02-24,2020-02-24,Rent
40906174,0,423672,-6103995,2020-02-24,2020-02-24,
40906174,11693,0,-6115688,2020-02-24,2020-02-24,Healthcare
40906174,19871,0,-6135559,2020-02-25,2020-02-25,Bill Sharing
40906174,0,396469,-5739090,2020-02-25,2020-02-25,
40906174,0,13459,-5725631,2020-02-26,2020-02-26,
40906174,0,354081,-5371550,2020-02-26,2020-02-26,
40906174,0,11670,-5359880,2020-02-26,2020-02-26,
40906174,10532,0,-5370412,2020-02-27,2020-02-27,Transportation
40906174,0,887498,-5387058,2020-02-28,2020-02-28,
40906174,313543,0,-5700601,2020-02-29,2020-02-29,Transportation
40906174,0,12850,-5687751,2020-03-01,2020-03-01,
40906174,17931,0,-5705682,2020-03-02,2020-03-02,Transportation
40906174,0,484893,-5220789,2020-03-02,2020-03-02,
40906174,0,414883,-4805906,2020-03-03,2020-03-03,
40906174,457958,0,-5263864,2020-03-04,2020-03-04,Education
40906174,0,441317,-4822547,2020-03-05,2020-03-05,
40906174,398479,0,-5221026,2020-03-05,2020-03-05,Clothes
40906174,0,19561,-5201465,2020-03-06,2020-03-06,
40906174,0,13674,-5187791,2020-03-06,2020-03-06,
40906174,0,342999,-4844792,2020-03-07,2020-03-07,
40906174,0,413266,-4857435,2020-03-07,2020-03-07,
40906174,479277,0,-5336712,2020-03-08,2020-03-08,Clothes
40906174,10410,0,-5347122,2020-03-09,2020-03-09,Utilities
40906174,373608,0,-5720730,2020-03-10,2020-03-10,Groceries
40906174,309106,0,-6029836,2020-03-10,2020-03-10,Bill Sharing
40906174,10598,0,-6040434,2020-03-11,2020-03-11,Clothes
40906174,408229,0,-6448663,2020-03-11,2020-03-11,Rent
40906174,483075,0,-6931738,2020-03-11,2020-03-11,Transportation
40906174,0,17848,-6913890,2020-03-12,2020-03-12,
40906174,17308,0,-6931198,2020-03-13,2020-03-13,Education
40906174,0,10713,-6920485,2020-03-13,2020-03-13,
40906174,322343,0,-7242828,2020-03-13,2020-03-13,Rent
40906174,432797,0,-7675625,2020-03-14,2020-03-14,Entertainment
40906174,468866,0,-8144491,2020-03-15,2020-03-15,Rent
40906174,0,496247,-8610420,2020-03-15,2020-03-15,
40906174,0,12241,-8598179,2020-03-15,2020-03-15,
40906174,0,15480,-8582699,2020-03-16,2020-03-16,
40906174,476439,0,-9059138,2020-03-16,2020-03-16,Transportation
40906174,404089,0,-9463227,2020-03-16,2020-03-16,Clothes
40906174,0,418053,-9045174,2020-03-17,2020-03-17,
40906174,0,339797,-8705377,2020-03-18,2020-03-18,
40906174,0,348302,-8357075,2020-03-18,2020-03-18,
40906174,14365,0,-8371440,2020-03-19,2020-03-19,Education
40906174,0,307351,-8064089,2020-03-19,2020-03-19,
40906174,10411,0,-8074500,2020-03-19,2020-03-19,Transportation
40906174,0,485905,-7588595,2020-03-20,2020-03-20,
40906174,0,19972,-7568623,2020-03-20,2020-03-20,
40906174,0,19503,-7549120,2020-03-20,2020-03-20,
40906174,15110,0,-7564230,2020-03-21,2020-03-21,Bill Sharing
40906174,16451,0,-7580681,2020-03-21,2020-03-21,Healthcare
40906174,0,393317,-7187364,2020-03-22,2020-03-22,
40906174,0,392728,-6794636,2020-03-22,2020-03-22,
40906174,325214,0,-7119850,2020-03-23,2020-03-23,Transportation
40906174,371449,0,-7491299,2020-03-23,2020-03-23,Bill Sharing
40906174,0,12087,-7479212,2020-03-23,2020-03-23,
40906174,356473,0,-7835685,2020-03-24,2020-03-24,Bill Sharing
40906174,0,488902,-7346783,2020-03-24,2020-03-24,
40906174,0,11255,-7335528,2020-03-25,2020-03-25,
40906174,14637,0,-7350165,2020-03-25,2020-03-25,Entertainment
40906174,15241,0,-7365406,2020-03-26,2020-03-26,Clothes
40906174,0,19437,-7345969,2020-03-27,2020-03-27,
40906174,0,360120,-6985849,2020-03-28,2020-03-28,
40906174,0,479454,-6506395,2020-03-28,2020-03-28,
40906174,0,364457,-6141938,2020-03-29,2020-03-29,
40906174,466396,0,-6608334,2020-03-30,2020-03-30,Bill Sharing
40906174,0,10740,-6597594,2020-03-30,2020-03-30,
40906174,17566,0,-6615160,2020-03-31,2020-03-31,Groceries
40906174,0,407220,-6207940,2020-04-01,2020-04-01,
40906174,14018,0,-6221958,2020-04-02,2020-04-02,Groceries
40906174,0,407658,-5814300,2020-04-03,2020-04-03,
40906174,0,466396,-5347904,2020-04-03,2020-04-03,
40906174,466811,0,-5814715,2020-04-04,2020-04-04,Education
40906174,0,421636,-5393079,2020-04-04,2020-04-04,
40906174,303852,0,-5696931,2020-04-05,2020-04-05,Healthcare
40906174,0,12307,-5684624,2020-04-06,2020-04-06,
40906174,382524,0,-6067148,2020-04-07,2020-04-07,Utilities
40906174,498517,0,-6565665,2020-04-07,2020-04-07,Entertainment
40906174,0,350810,-6214855,2020-04-08,2020-04-08,
40906174,404095,0,-6618950,2020-04-09,2020-04-09,Healthcare
40906174,0,434609,-6184341,2020-04-09,2020-04-09,
40906174,18120,0,-6202461,2020-04-09,2020-04-09,Clothes
40906174,405796,0,-6608257,2020-04-10,2020-04-10,Utilities
40906174,421011,0,-7029268,2020-04-10,2020-04-10,Transportation
40906174,0,12453,-7016815,2020-04-10,2020-04-10,
40906174,373313,0,-7390128,2020-04-11,2020-04-11,Utilities
40906174,325530,0,-7715658,2020-04-11,2020-04-11,Entertainment
40906174,0,15887,-7699771,2020-04-11,2020-04-11,
40906174,0,15680,-7684091,2020-04-12,2020-04-12,
40906174,11855,0,-7695946,2020-04-12,2020-04-12,Education
40906174,336492,0,-8032438,2020-04-13,2020-04-13,Healthcare
40906174,15499,0,-8047937,2020-04-14,2020-04-14,Entertainment
40906174,0,350417,-7697520,2020-04-14,2020-04-14,
40906174,426999,0,-8124519,2020-04-14,2020-04-14,Bill Sharing
40906174,0,15408,-8109111,2020-04-15,2020-04-15,
40906174,0,306070,-7803041,2020-04-16,2020-04-16,
40906174,0,11491,-7791550,2020-04-17,2020-04-17,
40906174,0,353471,-7438079,2020-04-17,2020-04-17,
40906174,460997,0,-7899076,2020-04-17,2020-04-17,Utilities
40906174,474594,0,-8373670,2020-04-18,2020-04-18,Utilities
40906174,0,358197,-8015473,2020-04-18,2020-04-18,
40906174,418622,0,-8434095,2020-04-18,2020-04-18,Groceries
40906174,0,436457,-7997638,2020-04-19,2020-04-19,
40906174,0,347818,-7649820,2020-04-20,2020-04-20,
40906174,0,381418,-7268402,2020-04-20,2020-04-20,
40906174,0,19570,-7248832,2020-04-21,2020-04-21,
40906174,0,464280,-6784552,2020-04-22,2020-04-22,
40906174,438600,0,-7223152,2020-04-22,2020-04-22,Rent
40906174,0,17383,-7205769,2020-04-23,2020-04-23,
40906174,14250,0,-7220019,2020-04-23,2020-04-23,Groceries
40906174,375266,0,-7595285,2020-04-23,2020-04-23,Clothes
40906174,17805,0,-7613090,2020-04-24,2020-04-24,Rent
40906174,19858,0,-7632948,2020-04-24,2020-04-24,Education
40906174,0,404737,-7228211,2020-04-25,2020-04-25,
40906174,0,397532,-6830679,2020-04-26,2020-04-26,
40906174,358953,0,-7189632,2020-04-26,2020-04-26,Transportation
40906174,0,16178,-7173454,2020-04-27,2020-04-27,
40906174,0,412857,-6760597,2020-04-27,2020-04-27,
40906174,0,345070,-6415527,2020-04-27,2020-04-27,
40906174,316607,0,-6732134,2020-04-28,2020-04-28,Groceries
40906174,477554,0,-7209688,2020-04-28,2020-04-28,Education
40906174,360505,0,-7570193,2020-04-28,2020-04-28,Groceries
40906174,0,448283,-7121910,2020-04-29,2020-04-29,
40906174,0,12671,-7109239,2020-04-29,2020-04-29,
40906174,0,309366,-6799873,2020-04-30,2020-04-30,
40906174,0,410723,-6389150,2020-04-30,2020-04-30,
40906174,0,13752,-6375398,2020-05-01,2020-05-01,
40906174,0,14161,-6361237,2020-05-01,2020-05-01,
40906174,0,371900,-5989337,2020-05-01,2020-05-01,
40906174,0,458286,-5531051,2020-05-02,2020-05-02,
40906174,308108,0,-5839159,2020-05-02,2020-05-02,Healthcare
40906174,365177,0,-6204336,2020-05-03,2020-05-03,Utilities
40906174,17418,0,-6221754,2020-05-04,2020-05-04,Healthcare
40906174,14050,0,-6235804,2020-05-04,2020-05-04,Rent
40906174,413343,0,-6649147,2020-05-05,2020-05-05,Rent
40906174,14752,0,-6663899,2020-05-05,2020-05-05,Transportation
40906174,10338,0,-6674237,2020-05-05,2020-05-05,Education
40906174,462842,0,-7137079,2020-05-06,2020-05-06,Rent
40906174,0,464543,-6672536,2020-05-07,2020-05-07,
40906174,0,440136,-6232400,2020-05-07,2020-05-07,
40906174,15309,0,-6247709,2020-05-08,2020-05-08,Bill Sharing
40906174,11819,0,-6259528,2020-05-09,2020-05-09,Bill Sharing
40906174,14971,0,-6274499,2020-05-10,2020-05-10,Healthcare
40906174,0,462884,-5811615,2020-05-10,2020-05-10,
40906174,0,402923,-5408692,2020-05-10,2020-05-10,
40906174,439196,0,-4955391,2020-05-11,2020-05-11,Education
40906174,0,482541,-4472850,2020-05-11,2020-05-11,
40906174,0,360896,-4111954,2020-05-11,2020-05-11,
40906174,493413,0,-4605367,2020-05-12,2020-05-12,Entertainment
40906174,0,12839,-4592528,2020-05-12,2020-05-12,
40906174,0,13784,-4578744,2020-05-12,2020-05-12,
40906174,0,367471,-4211273,2020-05-13,2020-05-13,
40906174,0,355726,-3855547,2020-05-13,2020-05-13,
40906174,462117,0,-4317664,2020-05-13,2020-05-13,Rent
40906174,0,15225,-4302439,2020-05-14,2020-05-14,
40906174,19806,0,-4322245,2020-05-14,2020-05-14,Entertainment
40906174,589500,0,-4334109,2020-05-14,2020-05-14,Healthcare
40906174,16053,0,-4350162,2020-05-15,2020-05-15,Utilities
40906174,0,462526,-3887636,2020-05-15,2020-05-15,
40906174,16922,0,-3904558,2020-05-15,2020-05-15,Entertainment
40906174,0,11839,-3892719,2020-05-16,2020-05-16,
40906174,17930,0,-3910649,2020-05-16,2020-05-16,Entertainment
40906174,371651,0,-4282300,2020-05-16,2020-05-16,Rent
40906174,0,11788,-4270512,2020-05-17,2020-05-17,
40906174,0,17554,-4252958,2020-05-17,2020-05-17,
40906174,0,450009,-3802949,2020-05-18,2020-05-18,
40906174,10734,0,-3813683,2020-05-18,2020-05-18,Healthcare
40906174,381368,0,-4195051,2020-05-18,2020-05-18,Clothes
40906174,0,19696,-4175355,2020-05-19,2020-05-19,
40906174,12991,0,-4188346,2020-05-19,2020-05-19,Healthcare
40906174,13379,0,-4201725,2020-05-20,2020-05-20,Education
40906174,0,19884,-4181841,2020-05-20,2020-05-20,
40906174,482485,0,-4664326,2020-05-21,2020-05-21,Healthcare
40906174,10594,0,-4674920,2020-05-21,2020-05-21,Groceries
40906174,14679,0,-4689599,2020-05-21,2020-05-21,Healthcare
40906174,395112,0,-5084711,2020-05-22,2020-05-22,Bill Sharing
40906174,0,392994,-4691717,2020-05-23,2020-05-23,
40906174,0,390234,-4301483,2020-05-23,2020-05-23,
40906174,366635,0,-4668118,2020-05-24,2020-05-24,Groceries
40906174,427523,0,-5095641,2020-05-25,2020-05-25,Groceries
40906174,0,14347,-5081294,2020-05-25,2020-05-25,
40906174,0,369911,-4711383,2020-05-26,2020-05-26,
40906174,17681,0,-4729064,2020-05-26,2020-05-26,Utilities
40906174,0,363986,-4365078,2020-05-26,2020-05-26,
40906174,410781,0,-4775859,2020-05-27,2020-05-27,Clothes
40906174,0,10334,-4765525,2020-05-27,2020-05-27,
40906174,0,438660,-4326865,2020-05-28,2020-05-28,
40906174,321578,0,-4648443,2020-05-28,2020-05-28,Utilities
40906174,0,308409,-4340034,2020-05-28,2020-05-28,
40906174,10092,0,-4350126,2020-05-29,2020-05-29,Healthcare
40906174,369191,0,-4719317,2020-05-30,2020-05-30,Rent
40906174,0,11156,-4708161,2020-05-30,2020-05-30,
40906174,12849,0,-4721010,2020-05-30,2020-05-30,Clothes
40906174,428632,0,-5149642,2020-05-31,2020-05-31,Entertainment
40906174,416605,0,-5566247,2020-05-31,2020-05-31,Bill Sharing
40906174,302119,0,-5868366,2020-05-31,2020-05-31,Rent
40906174,481079,0,-6349445,2020-06-01,2020-06-01,Rent
40906174,18994,0,-6368439,2020-06-01,2020-06-01,Utilities
40906174,411264,0,-6779703,2020-06-01,2020-06-01,Education
40906174,0,318942,-6460761,2020-06-02,2020-06-02,
40906174,11356,0,-6472117,2020-06-03,2020-06-03,Clothes
40906174,314192,0,-6786309,2020-06-04,2020-06-04,Groceries
40906174,0,317513,-6468796,2020-06-04,2020-06-04,
40906174,0,19543,-6449253,2020-06-04,2020-06-04,
40906174,348650,0,-6797903,2020-06-05,2020-06-05,Healthcare
40906174,0,459367,-6338536,2020-06-05,2020-06-05,
40906174,419592,0,-6758128,2020-06-06,2020-06-06,Transportation
40906174,0,314886,-6443242,2020-06-07,2020-06-07,
40906174,0,416404,-6026838,2020-06-07,2020-06-07,
40906174,460769,0,-6487607,2020-06-07,2020-06-07,Groceries
40906174,18700,0,-6506307,2020-06-08,2020-06-08,Clothes
40906174,366218,0,-6872525,2020-06-09,2020-06-09,Clothes
40906174,300667,0,-7173192,2020-06-10,2020-06-10,Utilities
40906174,0,326417,-6846775,2020-06-10,2020-06-10,
40906174,370181,0,-7216956,2020-06-11,2020-06-11,Education
40906174,15705,0,-7232661,2020-06-12,2020-06-12,Rent
40906174,440871,0,-7673532,2020-06-12,2020-06-12,Bill Sharing
40906174,378150,0,-8051682,2020-06-13,2020-06-13,Transportation
40906174,459940,0,-8511622,2020-06-13,2020-06-13,Healthcare
40906174,19037,0,-8530659,2020-06-14,2020-06-14,Clothes
40906174,0,680335,-8894220,2020-06-14,2020-06-14,
40906174,420756,0,-9314976,2020-06-14,2020-06-14,Groceries
40906174,328796,0,-9643772,2020-06-15,2020-06-15,Bill Sharing
40906174,0,402604,-9241168,2020-06-16,2020-06-16,
40906174,446939,0,-9688107,2020-06-16,2020-06-16,Utilities
40906174,0,10522,-9677585,2020-06-17,2020-06-17,
40906174,19843,0,-9697428,2020-06-17,2020-06-17,Healthcare
40906174,412225,0,-10109653,2020-06-17,2020-06-17,Entertainment
40906174,366178,0,-10475831,2020-06-18,2020-06-18,Healthcare
40906174,0,13937,-10461894,2020-06-18,2020-06-18,
40906174,14673,0,-10476567,2020-06-19,2020-06-19,Groceries
40906174,0,19192,-10457375,2020-06-19,2020-06-19,
40906174,0,429132,-10028243,2020-06-19,2020-06-19,
40906174,351579,0,-10379822,2020-06-20,2020-06-20,Education
40906174,362104,0,-10741926,2020-06-20,2020-06-20,Healthcare
40906174,11514,0,-10753440,2020-06-21,2020-06-21,Healthcare
40906174,320264,0,-11073704,2020-06-21,2020-06-21,Education
40906174,0,384357,-10689347,2020-06-21,2020-06-21,
40906174,0,374612,-10314735,2020-06-22,2020-06-22,
40906174,0,611618,-10014241,2020-06-22,2020-06-22,
40906174,0,369851,-9644390,2020-06-22,2020-06-22,
40906174,0,10294,-9634096,2020-06-23,2020-06-23,
40906174,437416,0,-9653045,2020-06-23,2020-06-23,Education
40906174,0,13891,-9639154,2020-06-23,2020-06-23,
40906174,0,348997,-9290157,2020-06-24,2020-06-24,
40906174,0,338467,-8951690,2020-06-24,2020-06-24,
40906174,394702,0,-9346392,2020-06-25,2020-06-25,Entertainment
40906174,0,479770,-8866622,2020-06-25,2020-06-25,
40906174,0,304378,-8562244,2020-06-26,2020-06-26,
40906174,0,510420,-8544212,2020-06-26,2020-06-26,
40906174,0,381453,-8162759,2020-06-27,2020-06-27,
40906174,0,345557,-7817202,2020-06-27,2020-06-27,
40906174,0,19857,-7797345,2020-06-28,2020-06-28,
40906174,18452,0,-7815797,2020-06-28,2020-06-28,Utilities
40906174,17021,0,-7832818,2020-06-28,2020-06-28,Transportation
40906174,0,367215,-7465603,2020-06-29,2020-06-29,
40906174,0,14421,-7451182,2020-06-29,2020-06-29,
40906174,440437,0,-7891619,2020-06-30,2020-06-30,Bill Sharing
40906174,374209,0,-8265828,2020-07-01,2020-07-01,Clothes
40906174,10941,0,-8276769,2020-07-01,2020-07-01,Bill Sharing
40906174,330175,0,-8606944,2020-07-01,2020-07-01,Transportation
40906174,485295,0,-9092239,2020-07-02,2020-07-02,Healthcare
40906174,0,13345,-9078894,2020-07-03,2020-07-03,
40906174,0,10848,-9068046,2020-07-04,2020-07-04,
40906174,331516,0,-9399562,2020-07-05,2020-07-05,Transportation
40906174,384229,0,-9783791,2020-07-05,2020-07-05,Transportation
40906174,424341,0,-10208132,2020-07-06,2020-07-06,Clothes
40906174,0,326317,-9881815,2020-07-06,2020-07-06,
40906174,13007,0,-9894822,2020-07-06,2020-07-06,Education
40906174,0,17431,-9877391,2020-07-07,2020-07-07,
40906174,0,352450,-9524941,2020-07-07,2020-07-07,
40906174,391691,0,-9916632,2020-07-07,2020-07-07,Bill Sharing
40906174,381750,0,-10298382,2020-07-08,2020-07-08,Transportation
40906174,19919,0,-10318301,2020-07-09,2020-07-09,Utilities
40906174,474904,0,-10793205,2020-07-09,2020-07-09,Clothes
40906174,0,17395,-10775810,2020-07-10,2020-07-10,
40906174,0,12165,-10763645,2020-07-10,2020-07-10,
40906174,0,10249,-10753396,2020-07-11,2020-07-11,
40906174,474640,0,-11228036,2020-07-12,2020-07-12,Entertainment
40906174,15171,0,-11243207,2020-07-12,2020-07-12,Groceries
40906174,0,301427,-10941780,2020-07-12,2020-07-12,
40906174,0,13257,-10928523,2020-07-13,2020-07-13,
40906174,0,19043,-10909480,2020-07-13,2020-07-13,
40906174,310515,0,-11219995,2020-07-14,2020-07-14,Healthcare
40906174,0,437463,-10782532,2020-07-14,2020-07-14,
40906174,433811,0,-11216343,2020-07-15,2020-07-15,Healthcare
40906174,12309,0,-11228652,2020-07-16,2020-07-16,Clothes
40906174,477547,0,-11706199,2020-07-16,2020-07-16,Utilities
40906174,0,18788,-11687411,2020-07-16,2020-07-16,
40906174,15866,0,-11703277,2020-07-17,2020-07-17,Rent
40906174,0,377992,-11325285,2020-07-18,2020-07-18,
40906174,0,12140,-11313145,2020-07-18,2020-07-18,
40906174,312425,0,-11625570,2020-07-18,2020-07-18,Transportation
40906174,0,12926,-11612644,2020-07-19,2020-07-19,
40906174,12505,0,-11625149,2020-07-19,2020-07-19,Clothes
40906174,523904,0,-11238695,2020-07-20,2020-07-20,Education
40906174,326098,0,-11564793,2020-07-20,2020-07-20,Transportation
40906174,0,494845,-11069948,2020-07-20,2020-07-20,
40906174,0,16401,-11053547,2020-07-21,2020-07-21,
40906174,0,483388,-10570159,2020-07-22,2020-07-22,
40906174,321290,0,-10891449,2020-07-22,2020-07-22,Clothes
40906174,19611,0,-10911060,2020-07-22,2020-07-22,Education
40906174,0,481315,-10429745,2020-07-23,2020-07-23,
40906174,0,427594,-10002151,2020-07-23,2020-07-23,
40906174,18029,0,-10020180,2020-07-23,2020-07-23,Bill Sharing
40906174,0,14370,-10005810,2020-07-24,2020-07-24,
40906174,327046,0,-10332856,2020-07-24,2020-07-24,Groceries
40906174,16535,0,-10349391,2020-07-25,2020-07-25,Bill Sharing
40906174,19240,0,-10368631,2020-07-25,2020-07-25,Rent
40906174,0,320934,-10047697,2020-07-26,2020-07-26,
40906174,345686,0,-10393383,2020-07-26,2020-07-26,Entertainment
40906174,0,11430,-10381953,2020-07-26,2020-07-26,
40906174,312928,0,-10694881,2020-07-27,2020-07-27,Entertainment
40906174,12268,0,-10707149,2020-07-27,2020-07-27,Healthcare
40906174,491104,0,-11198253,2020-07-27,2020-07-27,Healthcare
40906174,0,355053,-10843200,2020-07-28,2020-07-28,
40906174,0,395342,-10447858,2020-07-28,2020-07-28,
40906174,11585,0,-10459443,2020-07-28,2020-07-28,Rent
40906174,437141,0,-10896584,2020-07-29,2020-07-29,Transportation
40906174,14008,0,-10910592,2020-07-29,2020-07-29,Groceries
40906174,469208,0,-11379800,2020-07-30,2020-07-30,Transportation
40906174,411605,0,-11791405,2020-07-30,2020-07-30,Utilities
40906174,475648,0,-12267053,2020-07-30,2020-07-30,Healthcare
40906174,16011,0,-12283064,2020-07-31,2020-07-31,Healthcare
40906174,0,12887,-12270177,2020-07-31,2020-07-31,
40906174,494801,0,-12764978,2020-08-01,2020-08-01,Transportation
40906174,412826,0,-13177804,2020-08-02,2020-08-02,Utilities
40906174,0,373174,-12804630,2020-08-02,2020-08-02,
40906174,13716,0,-12818346,2020-08-03,2020-08-03,Bill Sharing
40906174,0,10730,-12807616,2020-08-03,2020-08-03,
40906174,18145,0,-12825761,2020-08-04,2020-08-04,Entertainment
40906174,0,16368,-12809393,2020-08-05,2020-08-05,
40906174,0,461027,-12348366,2020-08-05,2020-08-05,
40906174,362230,0,-12710596,2020-08-05,2020-08-05,Utilities
40906174,373158,0,-13083754,2020-08-06,2020-08-06,Utilities
40906174,457069,0,-13540823,2020-08-06,2020-08-06,Transportation
40906174,349442,0,-13890265,2020-08-06,2020-08-06,Bill Sharing
40906174,400425,0,-14290690,2020-08-07,2020-08-07,Clothes
40906174,18959,0,-14309649,2020-08-08,2020-08-08,Healthcare
40906174,0,357451,-13952198,2020-08-08,2020-08-08,
40906174,0,426763,-13525435,2020-08-08,2020-08-08,
40906174,0,16769,-13508666,2020-08-09,2020-08-09,
40906174,0,312502,-13196164,2020-08-10,2020-08-10,
40906174,483033,0,-13679197,2020-08-10,2020-08-10,Bill Sharing
40906174,0,364394,-13314803,2020-08-10,2020-08-10,
40906174,18837,0,-13333640,2020-08-11,2020-08-11,Clothes
40906174,11462,0,-13345102,2020-08-12,2020-08-12,Rent
40906174,378726,0,-13723828,2020-08-12,2020-08-12,Healthcare
40906174,0,428959,-13294869,2020-08-12,2020-08-12,
40906174,0,15724,-13279145,2020-08-13,2020-08-13,
40906174,0,10291,-13268854,2020-08-14,2020-08-14,
40906174,0,455646,-12813208,2020-08-15,2020-08-15,
40906174,0,468172,-12345036,2020-08-15,2020-08-15,
40906174,12296,0,-12357332,2020-08-16,2020-08-16,Groceries
40906174,17231,0,-12374563,2020-08-17,2020-08-17,Bill Sharing
40906174,0,412970,-11961593,2020-08-17,2020-08-17,
40906174,481422,0,-12443015,2020-08-18,2020-08-18,Groceries
40906174,19117,0,-12462132,2020-08-18,2020-08-18,Clothes
40906174,415091,0,-12877223,2020-08-19,2020-08-19,Education
40906174,0,441211,-12436012,2020-08-19,2020-08-19,
40906174,0,16954,-12419058,2020-08-20,2020-08-20,
40906174,0,19800,-12399258,2020-08-20,2020-08-20,
40906174,0,690952,-12046450,2020-08-20,2020-08-20,
40906174,0,909659,-11597375,2020-08-21,2020-08-21,
40906174,17039,0,-11614414,2020-08-21,2020-08-21,Rent
40906174,417294,0,-12031708,2020-08-22,2020-08-22,Entertainment
40906174,434469,0,-12466177,2020-08-22,2020-08-22,Transportation
40906174,0,303964,-12162213,2020-08-22,2020-08-22,
40906174,0,15650,-12146563,2020-08-23,2020-08-23,
40906174,0,15205,-12131358,2020-08-23,2020-08-23,
40906174,318789,0,-12450147,2020-08-23,2020-08-23,Clothes
40906174,0,461352,-11988795,2020-08-24,2020-08-24,
40906174,391092,0,-12379887,2020-08-24,2020-08-24,Transportation
40906174,0,11586,-12368301,2020-08-25,2020-08-25,
40906174,308681,0,-12676982,2020-08-25,2020-08-25,Education
40906174,10821,0,-12687803,2020-08-26,2020-08-26,Entertainment
40906174,0,476917,-12210886,2020-08-27,2020-08-27,
40906174,430797,0,-12641683,2020-08-28,2020-08-28,Transportation
40906174,0,363872,-12277811,2020-08-28,2020-08-28,
40906174,351669,0,-12629480,2020-08-28,2020-08-28,Utilities
40906174,0,11886,-12617594,2020-08-29,2020-08-29,
40906174,19130,0,-12636724,2020-08-29,2020-08-29,Education
40906174,0,329764,-12306960,2020-08-30,2020-08-30,
40906174,19210,0,-12326170,2020-08-30,2020-08-30,Education
40906174,0,12917,-12313253,2020-08-31,2020-08-31,
40906174,327268,0,-12640521,2020-09-01,2020-09-01,Utilities
40906174,0,324499,-12316022,2020-09-01,2020-09-01,
40906174,0,400846,-11915176,2020-09-02,2020-09-02,
40906174,369965,0,-12285141,2020-09-02,2020-09-02,Healthcare
40906174,336882,0,-12622023,2020-09-02,2020-09-02,Transportation
40906174,949886,0,-12289956,2020-09-03,2020-09-03,Healthcare
40906174,306228,0,-12596184,2020-09-04,2020-09-04,Utilities
40906174,0,12703,-12583481,2020-09-04,2020-09-04,
40906174,0,344813,-12238668,2020-09-05,2020-09-05,
40906174,17784,0,-12256452,2020-09-05,2020-09-05,Clothes
40906174,0,331876,-11924576,2020-09-06,2020-09-06,
40906174,12327,0,-11936903,2020-09-07,2020-09-07,Bill Sharing
40906174,0,16535,-11920368,2020-09-07,2020-09-07,
40906174,0,475015,-11445353,2020-09-07,2020-09-07,
40906174,0,326732,-11118621,2020-09-08,2020-09-08,
40906174,0,333433,-10785188,2020-09-08,2020-09-08,
40906174,394736,0,-11179924,2020-09-08,2020-09-08,Transportation
40906174,0,389272,-10790652,2020-09-09,2020-09-09,
40906174,365391,0,-11156043,2020-09-09,2020-09-09,Education
40906174,0,434448,-10721595,2020-09-10,2020-09-10,
40906174,0,12665,-10708930,2020-09-11,2020-09-11,
40906174,339630,0,-11048560,2020-09-11,2020-09-11,Rent
40906174,382346,0,-11430906,2020-09-12,2020-09-12,Clothes
40906174,0,17464,-11413442,2020-09-12,2020-09-12,
40906174,0,10347,-11403095,2020-09-12,2020-09-12,
40906174,14739,0,-11417834,2020-09-13,2020-09-13,Bill Sharing
40906174,0,12946,-11404888,2020-09-14,2020-09-14,
40906174,0,375176,-11029712,2020-09-15,2020-09-15,
40906174,371899,0,-11401611,2020-09-15,2020-09-15,Entertainment
40906174,0,382838,-11018773,2020-09-16,2020-09-16,
40906174,313756,0,-11332529,2020-09-16,2020-09-16,Utilities
40906174,0,463085,-10869444,2020-09-17,2020-09-17,
40906174,343621,0,-11213065,2020-09-18,2020-09-18,Education
40906174,18395,0,-11231460,2020-09-18,2020-09-18,Groceries
40906174,336646,0,-11568106,2020-09-18,2020-09-18,Transportation
40906174,0,18027,-11550079,2020-09-19,2020-09-19,
40906174,0,15538,-11534541,2020-09-20,2020-09-20,
40906174,0,381740,-11152801,2020-09-21,2020-09-21,
40906174,0,477948,-10674853,2020-09-22,2020-09-22,
40906174,385953,0,-11060806,2020-09-23,2020-09-23,Transportation
40906174,17871,0,-11078677,2020-09-23,2020-09-23,Entertainment
40906174,401223,0,-11479900,2020-09-24,2020-09-24,Utilities
40906174,11687,0,-11491587,2020-09-24,2020-09-24,Clothes
40906174,0,10595,-11480992,2020-09-25,2020-09-25,
40906174,0,19053,-11461939,2020-09-26,2020-09-26,
40906174,15451,0,-11477390,2020-09-26,2020-09-26,Bill Sharing
40906174,387354,0,-11864744,2020-09-26,2020-09-26,Entertainment
40906174,0,407368,-11457376,2020-09-27,2020-09-27,
40906174,0,19597,-11437779,2020-09-27,2020-09-27,
40906174,0,486518,-10951261,2020-09-28,2020-09-28,
40906174,0,497034,-10454227,2020-09-28,2020-09-28,
40906174,0,864984,-10470603,2020-09-29,2020-09-29,
40906174,0,16514,-10454089,2020-09-29,2020-09-29,
40906174,11126,0,-10465215,2020-09-30,2020-09-30,Utilities
40906174,15184,0,-10480399,2020-10-01,2020-10-01,Bill Sharing
40906174,0,19790,-10460609,2020-10-02,2020-10-02,
40906174,0,452789,-10007820,2020-10-02,2020-10-02,
40906174,0,15280,-9992540,2020-10-03,2020-10-03,
40906174,14615,0,-10007155,2020-10-03,2020-10-03,Entertainment
40906174,342567,0,-10349722,2020-10-03,2020-10-03,Healthcare
40906174,492364,0,-10842086,2020-10-04,2020-10-04,Bill Sharing
40906174,420108,0,-11262194,2020-10-05,2020-10-05,Education
40906174,0,460333,-10801861,2020-10-05,2020-10-05,
40906174,0,17329,-10784532,2020-10-05,2020-10-05,
40906174,548387,0,-10360173,2020-10-06,2020-10-06,Healthcare
40906174,0,315681,-10044492,2020-10-06,2020-10-06,
40906174,479561,0,-10524053,2020-10-06,2020-10-06,Education
40906174,383155,0,-10907208,2020-10-07,2020-10-07,Groceries
40906174,19660,0,-10926868,2020-10-07,2020-10-07,Education
40906174,14865,0,-10941733,2020-10-07,2020-10-07,Bill Sharing
40906174,310869,0,-11252602,2020-10-08,2020-10-08,Healthcare
40906174,13048,0,-11265650,2020-10-08,2020-10-08,Bill Sharing
40906174,383782,0,-11649432,2020-10-08,2020-10-08,Healthcare
40906174,0,432563,-11216869,2020-10-09,2020-10-09,
40906174,0,15706,-11201163,2020-10-09,2020-10-09,
40906174,478154,0,-11679317,2020-10-09,2020-10-09,Rent
40906174,0,337802,-11341515,2020-10-10,2020-10-10,
40906174,305477,0,-11646992,2020-10-10,2020-10-10,Utilities
40906174,0,17863,-11629129,2020-10-11,2020-10-11,
40906174,364675,0,-11993804,2020-10-11,2020-10-11,Rent
40906174,396075,0,-12389879,2020-10-11,2020-10-11,Groceries
40906174,0,422542,-11967337,2020-10-12,2020-10-12,
40906174,18910,0,-11986247,2020-10-13,2020-10-13,Entertainment
40906174,401752,0,-12387999,2020-10-13,2020-10-13,Groceries
40906174,0,436796,-11951203,2020-10-14,2020-10-14,
40906174,0,343949,-11607254,2020-10-15,2020-10-15,
40906174,433689,0,-12040943,2020-10-16,2020-10-16,Healthcare
40906174,13745,0,-12054688,2020-10-16,2020-10-16,Healthcare
40906174,16825,0,-12071513,2020-10-16,2020-10-16,Entertainment
40906174,300671,0,-12372184,2020-10-17,2020-10-17,Transportation
40906174,431755,0,-12803939,2020-10-17,2020-10-17,Clothes
40906174,11136,0,-12815075,2020-10-18,2020-10-18,Groceries
40906174,0,13118,-12801957,2020-10-18,2020-10-18,
40906174,11592,0,-12813549,2020-10-19,2020-10-19,Bill Sharing
40906174,439554,0,-13253103,2020-10-20,2020-10-20,Clothes
40906174,14105,0,-13267208,2020-10-20,2020-10-20,Bill Sharing
40906174,0,397558,-12869650,2020-10-20,2020-10-20,
40906174,0,813333,-12886927,2020-10-21,2020-10-21,
40906174,0,11657,-12875270,2020-10-21,2020-10-21,
40906174,0,18797,-12856473,2020-10-22,2020-10-22,
40906174,0,332753,-12523720,2020-10-22,2020-10-22,
40906174,475381,0,-12999101,2020-10-22,2020-10-22,Groceries
40906174,0,11345,-12987756,2020-10-23,2020-10-23,
40906174,12151,0,-12999907,2020-10-24,2020-10-24,Groceries
40906174,305446,0,-13305353,2020-10-24,2020-10-24,Utilities
40906174,16905,0,-13322258,2020-10-24,2020-10-24,Bill Sharing
40906174,12023,0,-13334281,2020-10-25,2020-10-25,Groceries
40906174,0,17230,-13317051,2020-10-25,2020-10-25,
40906174,957036,0,-12948043,2020-10-25,2020-10-25,Healthcare
40906174,19446,0,-12967489,2020-10-26,2020-10-26,Rent
40906174,434239,0,-13401728,2020-10-26,2020-10-26,Groceries
40906174,0,411236,-12990492,2020-10-26,2020-10-26,
40906174,13479,0,-13003971,2020-10-27,2020-10-27,Bill Sharing
40906174,0,399231,-12604740,2020-10-27,2020-10-27,
40906174,0,334666,-12270074,2020-10-27,2020-10-27,
40906174,446591,0,-12716665,2020-10-28,2020-10-28,Healthcare
40906174,0,359735,-12356930,2020-10-28,2020-10-28,
40906174,0,11509,-12345421,2020-10-29,2020-10-29,
40906174,435704,0,-12781125,2020-10-29,2020-10-29,Clothes
40906174,18945,0,-12800070,2020-10-30,2020-10-30,Entertainment
40906174,0,359894,-12440176,2020-10-30,2020-10-30,
40906174,0,367441,-12072735,2020-10-30,2020-10-30,
40906174,0,11514,-12061221,2020-10-31,2020-10-31,
40906174,10355,0,-12071576,2020-10-31,2020-10-31,Transportation
40906174,18346,0,-12089922,2020-11-01,2020-11-01,Groceries
40906174,396355,0,-12486277,2020-11-01,2020-11-01,Groceries
40906174,484485,0,-12970762,2020-11-01,2020-11-01,Bill Sharing
40906174,364444,0,-13335206,2020-11-02,2020-11-02,Rent
40906174,13805,0,-13349011,2020-11-03,2020-11-03,Transportation
40906174,352294,0,-13701305,2020-11-04,2020-11-04,Healthcare
40906174,0,11582,-13689723,2020-11-04,2020-11-04,
40906174,0,437280,-13252443,2020-11-04,2020-11-04,
40906174,350923,0,-13603366,2020-11-05,2020-11-05,Transportation
40906174,0,429307,-13174059,2020-11-06,2020-11-06,
40906174,0,15067,-13158992,2020-11-07,2020-11-07,
40906174,379549,0,-13538541,2020-11-08,2020-11-08,Transportation
40906174,19347,0,-13557888,2020-11-09,2020-11-09,Bill Sharing
40906174,0,436804,-13121084,2020-11-10,2020-11-10,
40906174,525165,0,-12652635,2020-11-10,2020-11-10,Healthcare
40906174,14790,0,-12667425,2020-11-11,2020-11-11,Bill Sharing
40906174,461724,0,-13129149,2020-11-12,2020-11-12,Education
40906174,693444,0,-12709169,2020-11-12,2020-11-12,Healthcare
40906174,464340,0,-13173509,2020-11-13,2020-11-13,Rent
40906174,352411,0,-13525920,2020-11-13,2020-11-13,Healthcare
40906174,0,385795,-13140125,2020-11-13,2020-11-13,
40906174,0,489546,-12650579,2020-11-14,2020-11-14,
40906174,0,343595,-12306984,2020-11-15,2020-11-15,
40906174,0,16474,-12290510,2020-11-15,2020-11-15,
40906174,12837,0,-12303347,2020-11-15,2020-11-15,Groceries
40906174,410978,0,-12714325,2020-11-16,2020-11-16,Healthcare
40906174,0,487438,-12226887,2020-11-16,2020-11-16,
40906174,445831,0,-12672718,2020-11-17,2020-11-17,Utilities
40906174,0,375511,-12297207,2020-11-17,2020-11-17,
40906174,0,389362,-11907845,2020-11-17,2020-11-17,
40906174,0,415091,-11492754,2020-11-18,2020-11-18,
40906174,0,371296,-11121458,2020-11-18,2020-11-18,
40906174,0,378189,-10743269,2020-11-18,2020-11-18,
40906174,19425,0,-10762694,2020-11-19,2020-11-19,Healthcare
40906174,400755,0,-11163449,2020-11-19,2020-11-19,Clothes
40906174,0,393063,-10770386,2020-11-20,2020-11-20,
40906174,0,423059,-10347327,2020-11-20,2020-11-20,
40906174,0,332175,-10015152,2020-11-21,2020-11-21,
40906174,0,354232,-9660920,2020-11-21,2020-11-21,
40906174,0,431451,-9229469,2020-11-21,2020-11-21,
40906174,15778,0,-9245247,2020-11-22,2020-11-22,Healthcare
40906174,464683,0,-9709930,2020-11-22,2020-11-22,Groceries
40906174,429729,0,-9692206,2020-11-22,2020-11-22,Education
40906174,0,17225,-9674981,2020-11-23,2020-11-23,
40906174,18716,0,-9693697,2020-11-23,2020-11-23,Entertainment
40906174,0,11987,-9681710,2020-11-23,2020-11-23,
40906174,0,14629,-9667081,2020-11-24,2020-11-24,
40906174,0,306141,-9360940,2020-11-25,2020-11-25,
40906174,0,384133,-8976807,2020-11-25,2020-11-25,
40906174,0,446535,-8530272,2020-11-25,2020-11-25,
40906174,0,495478,-8034794,2020-11-26,2020-11-26,
40906174,15651,0,-8050445,2020-11-26,2020-11-26,Utilities
40906174,17570,0,-8068015,2020-11-27,2020-11-27,Healthcare
40906174,0,12698,-8055317,2020-11-28,2020-11-28,
40906174,13277,0,-8068594,2020-11-29,2020-11-29,Bill Sharing
40906174,0,401869,-7666725,2020-11-29,2020-11-29,
40906174,0,17896,-7648829,2020-11-29,2020-11-29,
40906174,0,19263,-7629566,2020-11-30,2020-11-30,
40906174,16398,0,-7645964,2020-12-01,2020-12-01,Bill Sharing
40906174,17294,0,-7663258,2020-12-01,2020-12-01,Transportation
40906174,0,13777,-7649481,2020-12-02,2020-12-02,
40906174,0,385803,-7263678,2020-12-02,2020-12-02,
40906174,0,378738,-6884940,2020-12-03,2020-12-03,
40906174,0,15543,-6869397,2020-12-03,2020-12-03,
40906174,0,363894,-6505503,2020-12-04,2020-12-04,
40906174,445128,0,-6950631,2020-12-04,2020-12-04,Rent
40906174,478206,0,-7428837,2020-12-04,2020-12-04,Clothes
40906174,407182,0,-7836019,2020-12-05,2020-12-05,Education
40906174,0,15241,-7820778,2020-12-05,2020-12-05,
40906174,0,321237,-7499541,2020-12-05,2020-12-05,
40906174,488042,0,-7987583,2020-12-06,2020-12-06,Clothes
40906174,17905,0,-8005488,2020-12-06,2020-12-06,Bill Sharing
40906174,0,17707,-7987781,2020-12-07,2020-12-07,
40906174,317126,0,-8304907,2020-12-07,2020-12-07,Rent
40906174,623038,0,-7952626,2020-12-07,2020-12-07,Healthcare
40906174,305959,0,-8258585,2020-12-08,2020-12-08,Utilities
40906174,0,450873,-7807712,2020-12-08,2020-12-08,
40906174,0,13054,-7794658,2020-12-09,2020-12-09,
40906174,463521,0,-8258179,2020-12-09,2020-12-09,Transportation
40906174,0,18968,-8239211,2020-12-10,2020-12-10,
40906174,11763,0,-8250974,2020-12-10,2020-12-10,Groceries
40906174,390303,0,-8641277,2020-12-10,2020-12-10,Bill Sharing
40906174,0,424937,-8216340,2020-12-11,2020-12-11,
40906174,19203,0,-8235543,2020-12-11,2020-12-11,Healthcare
40906174,453646,0,-8689189,2020-12-11,2020-12-11,Groceries
40906174,13345,0,-8702534,2020-12-12,2020-12-12,Clothes
40906174,18846,0,-8721380,2020-12-12,2020-12-12,Transportation
40906174,479370,0,-9200750,2020-12-13,2020-12-13,Bill Sharing
40906174,0,15616,-9185134,2020-12-13,2020-12-13,
40906174,0,446485,-8738649,2020-12-13,2020-12-13,
40906174,16573,0,-8755222,2020-12-14,2020-12-14,Bill Sharing
40906174,19308,0,-8774530,2020-12-14,2020-12-14,Utilities
40906174,0,472371,-8302159,2020-12-14,2020-12-14,
40906174,0,479038,-7823121,2020-12-15,2020-12-15,
40906174,0,19900,-7803221,2020-12-15,2020-12-15,
40906174,0,14547,-7788674,2020-12-16,2020-12-16,
40906174,0,419085,-7369589,2020-12-17,2020-12-17,
40906174,386871,0,-7756460,2020-12-17,2020-12-17,Rent
40906174,0,443775,-7312685,2020-12-18,2020-12-18,
40906174,0,473154,-6839531,2020-12-18,2020-12-18,
40906174,18859,0,-6858390,2020-12-18,2020-12-18,Bill Sharing
40906174,0,423519,-6434871,2020-12-19,2020-12-19,
40906174,0,400177,-6034694,2020-12-19,2020-12-19,
40906174,14810,0,-6049504,2020-12-19,2020-12-19,Transportation
40906174,0,19609,-6029895,2020-12-20,2020-12-20,
40906174,0,325938,-5703957,2020-12-20,2020-12-20,
40906174,340044,0,-6044001,2020-12-20,2020-12-20,Rent
40906174,0,977139,-6026058,2020-12-21,2020-12-21,
40906174,0,448626,-5577432,2020-12-21,2020-12-21,
40906174,14143,0,-5591575,2020-12-22,2020-12-22,Entertainment
40906174,0,311125,-5280450,2020-12-23,2020-12-23,
40906174,414483,0,-5694933,2020-12-23,2020-12-23,Entertainment
40906174,18256,0,-5713189,2020-12-23,2020-12-23,Rent
40906174,362919,0,-6076108,2020-12-24,2020-12-24,Entertainment
40906174,0,12562,-6063546,2020-12-25,2020-12-25,
40906174,0,326711,-5736835,2020-12-25,2020-12-25,
40906174,0,341781,-5395054,2020-12-26,2020-12-26,
40906174,491908,0,-5886962,2020-12-26,2020-12-26,Rent
40906174,375970,0,-6262932,2020-12-26,2020-12-26,Bill Sharing
40906174,10549,0,-6273481,2020-12-27,2020-12-27,Clothes
40906174,411480,0,-6684961,2020-12-28,2020-12-28,Bill Sharing
40906174,429417,0,-7114378,2020-12-28,2020-12-28,Clothes
40906174,0,322071,-6792307,2020-12-28,2020-12-28,
40906174,0,10840,-6781467,2020-12-29,2020-12-29,
40906174,12931,0,-6794398,2020-12-30,2020-12-30,Healthcare
40906174,419967,0,-7214365,2020-12-31,2020-12-31,Clothes
40906174,432939,0,-7647304,2020-12-31,2020-12-31,Transportation
40906174,10006,0,-7657310,2020-12-31,2020-12-31,Entertainment
40906174,0,311742,-7345568,2021-01-01,2021-01-01,
40906174,19600,0,-7365168,2021-01-01,2021-01-01,Groceries
40906174,305947,0,-7671115,2021-01-02,2021-01-02,Education
40906174,0,342837,-7328278,2021-01-02,2021-01-02,
40906174,0,384650,-6943628,2021-01-03,2021-01-03,
40906174,389508,0,-7333136,2021-01-03,2021-01-03,Entertainment
40906174,446903,0,-7780039,2021-01-03,2021-01-03,Healthcare
40906174,13422,0,-7793461,2021-01-04,2021-01-04,Education
40906174,0,11831,-7781630,2021-01-04,2021-01-04,
40906174,12919,0,-7794549,2021-01-05,2021-01-05,Bill Sharing
40906174,12347,0,-7806896,2021-01-06,2021-01-06,Utilities
40906174,396664,0,-8203560,2021-01-07,2021-01-07,Healthcare
40906174,322789,0,-8526349,2021-01-07,2021-01-07,Education
40906174,0,16275,-8510074,2021-01-07,2021-01-07,
40906174,685555,0,-8492604,2021-01-08,2021-01-08,Healthcare
40906174,0,15171,-8477433,2021-01-08,2021-01-08,
40906174,391352,0,-8868785,2021-01-08,2021-01-08,Utilities
40906174,0,17315,-8851470,2021-01-09,2021-01-09,
40906174,0,17259,-8834211,2021-01-09,2021-01-09,
40906174,0,486625,-8347586,2021-01-09,2021-01-09,
40906174,0,353759,-7993827,2021-01-10,2021-01-10,
40906174,0,463926,-7529901,2021-01-10,2021-01-10,
40906174,18200,0,-7548101,2021-01-10,2021-01-10,Clothes
40906174,18919,0,-7567020,2021-01-11,2021-01-11,Transportation
40906174,0,15523,-7551497,2021-01-11,2021-01-11,
40906174,492924,0,-8044421,2021-01-11,2021-01-11,Transportation
40906174,335108,0,-8379529,2021-01-12,2021-01-12,Transportation
40906174,0,300348,-8079181,2021-01-13,2021-01-13,
40906174,0,386002,-7693179,2021-01-13,2021-01-13,
40906174,13218,0,-7706397,2021-01-14,2021-01-14,Entertainment
40906174,378881,0,-8085278,2021-01-14,2021-01-14,Bill Sharing
40906174,18635,0,-8103913,2021-01-15,2021-01-15,Groceries
40906174,0,323520,-7780393,2021-01-16,2021-01-16,
40906174,347728,0,-8128121,2021-01-16,2021-01-16,Transportation
40906174,0,390235,-7737886,2021-01-16,2021-01-16,
40906174,409196,0,-8147082,2021-01-17,2021-01-17,Rent
40906174,0,302216,-7844866,2021-01-17,2021-01-17,
40906174,0,307177,-7537689,2021-01-17,2021-01-17,
40906174,0,16299,-7521390,2021-01-18,2021-01-18,
40906174,0,305384,-7216006,2021-01-18,2021-01-18,
40906174,0,439799,-6776207,2021-01-18,2021-01-18,
40906174,437867,0,-7214074,2021-01-19,2021-01-19,Entertainment
40906174,400286,0,-7614360,2021-01-19,2021-01-19,Entertainment
40906174,17361,0,-7631721,2021-01-19,2021-01-19,Groceries
40906174,0,10117,-7621604,2021-01-20,2021-01-20,
40906174,0,412959,-7208645,2021-01-20,2021-01-20,
40906174,10362,0,-7219007,2021-01-20,2021-01-20,Groceries
40906174,0,412707,-6806300,2021-01-21,2021-01-21,
40906174,0,338108,-6468192,2021-01-22,2021-01-22,
40906174,18739,0,-6486931,2021-01-22,2021-01-22,Entertainment
40906174,0,482226,-6004705,2021-01-23,2021-01-23,
40906174,0,324095,-5680610,2021-01-24,2021-01-24,
40906174,0,10481,-5670129,2021-01-24,2021-01-24,
40906174,0,12592,-5657537,2021-01-24,2021-01-24,
40906174,0,10142,-5647395,2021-01-25,2021-01-25,
40906174,497875,0,-6145270,2021-01-26,2021-01-26,Groceries
40906174,14988,0,-6160258,2021-01-26,2021-01-26,Groceries
40906174,19366,0,-6179624,2021-01-26,2021-01-26,Healthcare
40906174,0,439321,-5740303,2021-01-27,2021-01-27,
40906174,14376,0,-5754679,2021-01-27,2021-01-27,Transportation
40906174,308406,0,-6063085,2021-01-28,2021-01-28,Transportation
40906174,422035,0,-6485120,2021-01-28,2021-01-28,Groceries
40906174,0,339003,-6146117,2021-01-29,2021-01-29,
40906174,0,18631,-6127486,2021-01-30,2021-01-30,
40906174,12628,0,-6140114,2021-01-30,2021-01-30,Bill Sharing
40906174,394076,0,-6534190,2021-01-31,2021-01-31,Education
40906174,0,304430,-6229760,2021-02-01,2021-02-01,
40906174,415817,0,-6645577,2021-02-02,2021-02-02,Entertainment
40906174,0,14701,-6630876,2021-02-02,2021-02-02,
40906174,969040,0,-6187507,2021-02-03,2021-02-03,Education
40906174,18600,0,-6206107,2021-02-03,2021-02-03,Entertainment
40906174,0,19056,-6187051,2021-02-04,2021-02-04,
40906174,0,399146,-5787905,2021-02-04,2021-02-04,
40906174,18940,0,-5806845,2021-02-04,2021-02-04,Entertainment
40906174,384510,0,-6191355,2021-02-05,2021-02-05,Rent
40906174,0,474918,-6558425,2021-02-06,2021-02-06,
40906174,357259,0,-6915684,2021-02-06,2021-02-06,Rent
40906174,0,14541,-6901143,2021-02-06,2021-02-06,
40906174,822668,0,-6469724,2021-02-07,2021-02-07,Education
40906174,0,19677,-6450047,2021-02-07,2021-02-07,
40906174,404709,0,-6854756,2021-02-07,2021-02-07,Groceries
40906174,347850,0,-7202606,2021-02-08,2021-02-08,Healthcare
40906174,0,17145,-7185461,2021-02-08,2021-02-08,
40906174,11743,0,-7197204,2021-02-08,2021-02-08,Healthcare
40906174,0,348524,-6848680,2021-02-09,2021-02-09,
40906174,344036,0,-7192716,2021-02-10,2021-02-10,Groceries
40906174,19710,0,-7212426,2021-02-10,2021-02-10,Transportation
40906174,0,359828,-6852598,2021-02-10,2021-02-10,
40906174,321408,0,-7174006,2021-02-11,2021-02-11,Entertainment
40906174,319160,0,-7493166,2021-02-11,2021-02-11,Transportation
40906174,0,331529,-7161637,2021-02-11,2021-02-11,
40906174,418072,0,-7579709,2021-02-12,2021-02-12,Transportation
40906174,0,463404,-7564899,2021-02-12,2021-02-12,
40906174,409860,0,-7974759,2021-02-13,2021-02-13,Clothes
40906174,0,19907,-7954852,2021-02-14,2021-02-14,
40906174,0,445410,-7509442,2021-02-15,2021-02-15,
40906174,470147,0,-7979589,2021-02-15,2021-02-15,Education
40906174,465396,0,-8444985,2021-02-16,2021-02-16,Utilities
40906174,0,14279,-8430706,2021-02-16,2021-02-16,
40906174,459074,0,-8889780,2021-02-17,2021-02-17,Education
40906174,338936,0,-9228716,2021-02-17,2021-02-17,Healthcare
40906174,362647,0,-9591363,2021-02-18,2021-02-18,Entertainment
40906174,0,390255,-9201108,2021-02-18,2021-02-18,
40906174,17805,0,-9218913,2021-02-18,2021-02-18,Healthcare
40906174,315965,0,-9534878,2021-02-19,2021-02-19,Entertainment
40906174,16286,0,-9551164,2021-02-19,2021-02-19,Education
40906174,18225,0,-9569389,2021-02-19,2021-02-19,Groceries
40906174,0,16583,-9552806,2021-02-20,2021-02-20,
40906174,0,17221,-9535585,2021-02-20,2021-02-20,
40906174,0,18442,-9517143,2021-02-20,2021-02-20,
40906174,18225,0,-9535368,2021-02-21,2021-02-21,Clothes
40906174,353410,0,-9888778,2021-02-21,2021-02-21,Healthcare
40906174,0,363894,-9524884,2021-02-22,2021-02-22,
40906174,0,17387,-9507497,2021-02-22,2021-02-22,
40906174,348373,0,-9855870,2021-02-22,2021-02-22,Utilities
40906174,16338,0,-9872208,2021-02-23,2021-02-23,Entertainment
40906174,491872,0,-10364080,2021-02-23,2021-02-23,Healthcare
40906174,471116,0,-10835196,2021-02-24,2021-02-24,Rent
40906174,0,448148,-10387048,2021-02-24,2021-02-24,
40906174,12011,0,-10399059,2021-02-24,2021-02-24,Groceries
40906174,0,11816,-10387243,2021-02-25,2021-02-25,
40906174,0,19408,-10367835,2021-02-25,2021-02-25,
40906174,485191,0,-10853026,2021-02-25,2021-02-25,Education
40906174,12301,0,-10865327,2021-02-26,2021-02-26,Bill Sharing
40906174,14085,0,-10879412,2021-02-26,2021-02-26,Healthcare
40906174,433860,0,-11313272,2021-02-26,2021-02-26,Healthcare
40906174,0,469320,-10843952,2021-02-27,2021-02-27,
40906174,499041,0,-11342993,2021-02-27,2021-02-27,Entertainment
40906174,11373,0,-11354366,2021-02-28,2021-02-28,Entertainment
40906174,0,473981,-10880385,2021-02-28,2021-02-28,
40906174,12733,0,-10893118,2021-02-28,2021-02-28,Healthcare
40906174,0,19020,-10874098,2021-03-01,2021-03-01,
40906174,0,494833,-10379265,2021-03-02,2021-03-02,
40906174,13403,0,-10392668,2021-03-02,2021-03-02,Transportation
40906174,0,14022,-10378646,2021-03-03,2021-03-03,
40906174,0,329911,-10048735,2021-03-04,2021-03-04,
40906174,385507,0,-10434242,2021-03-04,2021-03-04,Healthcare
40906174,405799,0,-10840041,2021-03-05,2021-03-05,Education
40906174,487922,0,-11327963,2021-03-06,2021-03-06,Groceries
40906174,0,431817,-10896146,2021-03-07,2021-03-07,
40906174,16479,0,-10912625,2021-03-08,2021-03-08,Bill Sharing
40906174,0,473544,-10439081,2021-03-09,2021-03-09,
40906174,0,384376,-10054705,2021-03-09,2021-03-09,
40906174,315081,0,-10369786,2021-03-09,2021-03-09,Bill Sharing
40906174,0,15235,-10354551,2021-03-10,2021-03-10,
40906174,0,10695,-10343856,2021-03-10,2021-03-10,
40906174,461124,0,-10804980,2021-03-10,2021-03-10,Groceries
40906174,406455,0,-11211435,2021-03-11,2021-03-11,Rent
40906174,388639,0,-11600074,2021-03-12,2021-03-12,Bill Sharing
40906174,0,10464,-11589610,2021-03-12,2021-03-12,
40906174,301494,0,-11891104,2021-03-13,2021-03-13,Education
40906174,0,409035,-11482069,2021-03-13,2021-03-13,
40906174,0,451211,-11030858,2021-03-13,2021-03-13,
40906174,0,392316,-10638542,2021-03-14,2021-03-14,
40906174,0,14319,-10624223,2021-03-15,2021-03-15,
40906174,16842,0,-10641065,2021-03-15,2021-03-15,Entertainment
40906174,0,370442,-10270623,2021-03-15,2021-03-15,
40906174,0,16742,-10253881,2021-03-16,2021-03-16,
40906174,478395,0,-10732276,2021-03-17,2021-03-17,Utilities
40906174,17372,0,-10749648,2021-03-17,2021-03-17,Education
40906174,497237,0,-11246885,2021-03-18,2021-03-18,Education
40906174,0,414812,-10832073,2021-03-18,2021-03-18,
40906174,0,430434,-10401639,2021-03-19,2021-03-19,
40906174,463367,0,-10865006,2021-03-19,2021-03-19,Healthcare
40906174,11466,0,-10876472,2021-03-19,2021-03-19,Bill Sharing
40906174,0,498129,-10378343,2021-03-20,2021-03-20,
40906174,0,11597,-10366746,2021-03-20,2021-03-20,
40906174,0,314539,-10052207,2021-03-21,2021-03-21,
40906174,15377,0,-10067584,2021-03-21,2021-03-21,Transportation
40906174,0,11832,-10055752,2021-03-21,2021-03-21,
40906174,0,439193,-9616559,2021-03-22,2021-03-22,
40906174,0,493170,-9123389,2021-03-23,2021-03-23,
40906174,0,14789,-9108600,2021-03-24,2021-03-24,
40906174,495911,0,-9604511,2021-03-24,2021-03-24,Education
40906174,304762,0,-9909273,2021-03-25,2021-03-25,Transportation
40906174,12493,0,-9921766,2021-03-26,2021-03-26,Education
40906174,0,18082,-9903684,2021-03-27,2021-03-27,
40906174,0,467172,-9436512,2021-03-28,2021-03-28,
40906174,19572,0,-9456084,2021-03-28,2021-03-28,Entertainment
40906174,354067,0,-9810151,2021-03-28,2021-03-28,Groceries
40906174,457212,0,-10267363,2021-03-29,2021-03-29,Groceries
40906174,0,472459,-9794904,2021-03-30,2021-03-30,
40906174,305353,0,-10100257,2021-03-30,2021-03-30,Entertainment
40906174,12460,0,-10112717,2021-03-30,2021-03-30,Healthcare
40906174,16954,0,-10129671,2021-03-31,2021-03-31,Education
40906174,0,368362,-9761309,2021-04-01,2021-04-01,
40906174,0,19181,-9742128,2021-04-02,2021-04-02,
40906174,399000,0,-10141128,2021-04-03,2021-04-03,Entertainment
40906174,369181,0,-10510309,2021-04-03,2021-04-03,Healthcare
40906174,412044,0,-10922353,2021-04-03,2021-04-03,Entertainment
40906174,0,16630,-10905723,2021-04-04,2021-04-04,
40906174,16176,0,-10921899,2021-04-04,2021-04-04,Bill Sharing
40906174,0,14505,-10907394,2021-04-04,2021-04-04,
40906174,0,468429,-10438965,2021-04-05,2021-04-05,
40906174,302618,0,-10741583,2021-04-06,2021-04-06,Clothes
40906174,0,395267,-10346316,2021-04-06,2021-04-06,
40906174,0,372685,-9973631,2021-04-07,2021-04-07,
40906174,15619,0,-9989250,2021-04-07,2021-04-07,Healthcare
40906174,0,17270,-9971980,2021-04-08,2021-04-08,
40906174,12481,0,-9984461,2021-04-08,2021-04-08,Rent
40906174,0,11219,-9973242,2021-04-09,2021-04-09,
40906174,0,335838,-9637404,2021-04-09,2021-04-09,
40906174,680330,0,-9161690,2021-04-10,2021-04-10,Education
40906174,15475,0,-9177165,2021-04-10,2021-04-10,Transportation
40906174,0,19051,-9158114,2021-04-11,2021-04-11,
40906174,0,806119,-8719260,2021-04-11,2021-04-11,
40906174,0,15733,-8703527,2021-04-11,2021-04-11,
40906174,358703,0,-9062230,2021-04-12,2021-04-12,Entertainment
40906174,0,426257,-8635973,2021-04-12,2021-04-12,
40906174,0,17955,-8618018,2021-04-13,2021-04-13,
40906174,0,351045,-8266973,2021-04-13,2021-04-13,
40906174,0,11533,-8255440,2021-04-13,2021-04-13,
40906174,474169,0,-8729609,2021-04-14,2021-04-14,Transportation
40906174,327889,0,-9057498,2021-04-14,2021-04-14,Bill Sharing
40906174,0,428829,-8628669,2021-04-14,2021-04-14,
40906174,0,15792,-8612877,2021-04-15,2021-04-15,
40906174,0,466951,-8145926,2021-04-15,2021-04-15,
40906174,18038,0,-8163964,2021-04-16,2021-04-16,Rent
40906174,311034,0,-8474998,2021-04-17,2021-04-17,Healthcare
40906174,0,470173,-8004825,2021-04-17,2021-04-17,
40906174,0,461000,-7543825,2021-04-18,2021-04-18,
40906174,0,392792,-7151033,2021-04-18,2021-04-18,
40906174,444607,0,-7595640,2021-04-18,2021-04-18,Entertainment
40906174,0,380434,-7215206,2021-04-19,2021-04-19,
40906174,13972,0,-7229178,2021-04-19,2021-04-19,Entertainment
40906174,395590,0,-7624768,2021-04-20,2021-04-20,Entertainment
40906174,0,396323,-7228445,2021-04-21,2021-04-21,
40906174,519620,0,-6786245,2021-04-21,2021-04-21,Healthcare
40906174,329246,0,-7115491,2021-04-22,2021-04-22,Groceries
40906174,306242,0,-7421733,2021-04-22,2021-04-22,Clothes
40906174,317729,0,-7739462,2021-04-22,2021-04-22,Healthcare
40906174,409322,0,-8148784,2021-04-23,2021-04-23,Education
40906174,18974,0,-8167758,2021-04-23,2021-04-23,Utilities
40906174,0,17743,-8150015,2021-04-23,2021-04-23,
40906174,460282,0,-8610297,2021-04-24,2021-04-24,Bill Sharing
40906174,0,372203,-8238094,2021-04-24,2021-04-24,
40906174,356229,0,-8594323,2021-04-24,2021-04-24,Entertainment
40906174,0,413772,-8180551,2021-04-25,2021-04-25,
40906174,18298,0,-8198849,2021-04-25,2021-04-25,Bill Sharing
40906174,0,459705,-7739144,2021-04-26,2021-04-26,
40906174,462366,0,-8201510,2021-04-27,2021-04-27,Clothes
40906174,424359,0,-8625869,2021-04-27,2021-04-27,Education
40906174,336231,0,-8962100,2021-04-27,2021-04-27,Clothes
40906174,0,14810,-8947290,2021-04-28,2021-04-28,
40906174,0,480871,-8466419,2021-04-28,2021-04-28,
40906174,0,469745,-7996674,2021-04-28,2021-04-28,
40906174,0,10269,-7986405,2021-04-29,2021-04-29,
40906174,0,15591,-7970814,2021-04-29,2021-04-29,
40906174,533537,0,-7953300,2021-04-30,2021-04-30,Education
40906174,0,452317,-7500983,2021-04-30,2021-04-30,
40906174,0,11002,-7489981,2021-05-01,2021-05-01,
40906174,10630,0,-7500611,2021-05-02,2021-05-02,Transportation
40906174,0,311655,-7188956,2021-05-02,2021-05-02,
40906174,14225,0,-7203181,2021-05-02,2021-05-02,Transportation
40906174,0,19680,-7183501,2021-05-03,2021-05-03,
40906174,0,491745,-6691756,2021-05-04,2021-05-04,
40906174,572579,0,-6677070,2021-05-04,2021-05-04,Education
40906174,352750,0,-7029820,2021-05-04,2021-05-04,Bill Sharing
40906174,0,437812,-6592008,2021-05-05,2021-05-05,
40906174,318767,0,-6910775,2021-05-06,2021-05-06,Transportation
40906174,445584,0,-7356359,2021-05-06,2021-05-06,Entertainment
40906174,0,332734,-7023625,2021-05-06,2021-05-06,
40906174,0,14429,-7009196,2021-05-07,2021-05-07,
40906174,480230,0,-6548032,2021-05-08,2021-05-08,Healthcare
40906174,325743,0,-6873775,2021-05-08,2021-05-08,Clothes
40906174,0,359428,-6514347,2021-05-09,2021-05-09,
40906174,0,12920,-6501427,2021-05-09,2021-05-09,
40906174,491176,0,-6992603,2021-05-09,2021-05-09,Clothes
40906174,0,13091,-6979512,2021-05-10,2021-05-10,
40906174,365969,0,-7345481,2021-05-10,2021-05-10,Transportation
40906174,0,18972,-7326509,2021-05-11,2021-05-11,
40906174,819306,0,-6955709,2021-05-12,2021-05-12,Healthcare
40906174,19663,0,-6975372,2021-05-12,2021-05-12,Bill Sharing
40906174,0,376938,-6598434,2021-05-13,2021-05-13,
40906174,19670,0,-6618104,2021-05-13,2021-05-13,Clothes
40906174,0,10065,-6608039,2021-05-14,2021-05-14,
40906174,0,488286,-6119753,2021-05-14,2021-05-14,
40906174,345580,0,-6465333,2021-05-14,2021-05-14,Rent
40906174,340115,0,-6805448,2021-05-15,2021-05-15,Bill Sharing
40906174,11869,0,-6817317,2021-05-16,2021-05-16,Entertainment
40906174,0,361955,-6455362,2021-05-16,2021-05-16,
40906174,19711,0,-6475073,2021-05-16,2021-05-16,Bill Sharing
40906174,0,16642,-6458431,2021-05-17,2021-05-17,
40906174,0,11693,-6446738,2021-05-17,2021-05-17,
40906174,0,325154,-6121584,2021-05-17,2021-05-17,
40906174,682128,0,-6138964,2021-05-18,2021-05-18,Healthcare
40906174,10011,0,-6148975,2021-05-18,2021-05-18,Clothes
40906174,0,461898,-5687077,2021-05-18,2021-05-18,
40906174,14069,0,-5701146,2021-05-19,2021-05-19,Education
40906174,0,17168,-5683978,2021-05-19,2021-05-19,
40906174,0,14383,-5669595,2021-05-19,2021-05-19,
40906174,13873,0,-5683468,2021-05-20,2021-05-20,Transportation
40906174,0,779944,-5672791,2021-05-20,2021-05-20,
40906174,10899,0,-5683690,2021-05-20,2021-05-20,Entertainment
40906174,0,12804,-5670886,2021-05-21,2021-05-21,
40906174,443779,0,-5651208,2021-05-22,2021-05-22,Education
40906174,0,417293,-5233915,2021-05-22,2021-05-22,
40906174,0,393890,-4840025,2021-05-23,2021-05-23,
40906174,428446,0,-5268471,2021-05-23,2021-05-23,Utilities
40906174,0,323469,-4945002,2021-05-23,2021-05-23,
40906174,323335,0,-5268337,2021-05-24,2021-05-24,Groceries
40906174,19074,0,-5287411,2021-05-24,2021-05-24,Groceries
40906174,322475,0,-5609886,2021-05-24,2021-05-24,Clothes
40906174,0,19421,-5590465,2021-05-25,2021-05-25,
40906174,382392,0,-5972857,2021-05-25,2021-05-25,Utilities
40906174,453029,0,-6425886,2021-05-26,2021-05-26,Groceries
40906174,418160,0,-6844046,2021-05-26,2021-05-26,Utilities
40906174,377249,0,-7221295,2021-05-26,2021-05-26,Education
40906174,0,342620,-6878675,2021-05-27,2021-05-27,
40906174,0,327463,-6551212,2021-05-27,2021-05-27,
40906174,307531,0,-6858743,2021-05-28,2021-05-28,Transportation
40906174,654341,0,-7230599,2021-05-29,2021-05-29,Healthcare
40906174,14210,0,-7244809,2021-05-29,2021-05-29,Healthcare
40906174,451562,0,-7696371,2021-05-30,2021-05-30,Utilities
40906174,475380,0,-7257034,2021-05-30,2021-05-30,Healthcare
40906174,376500,0,-7633534,2021-05-31,2021-05-31,Education
40906174,11353,0,-7644887,2021-06-01,2021-06-01,Transportation
40906174,424161,0,-8069048,2021-06-01,2021-06-01,Transportation
40906174,10186,0,-8079234,2021-06-01,2021-06-01,Education
40906174,0,435216,-7644018,2021-06-02,2021-06-02,
40906174,18738,0,-7662756,2021-06-02,2021-06-02,Education
40906174,388147,0,-8050903,2021-06-03,2021-06-03,Education
40906174,0,816438,-8040801,2021-06-03,2021-06-03,
40906174,17312,0,-8058113,2021-06-03,2021-06-03,Healthcare
40906174,372677,0,-8430790,2021-06-04,2021-06-04,Groceries
40906174,0,17302,-8413488,2021-06-05,2021-06-05,
40906174,384662,0,-8798150,2021-06-06,2021-06-06,Education
40906174,459134,0,-9257284,2021-06-06,2021-06-06,Healthcare
40906174,16751,0,-9274035,2021-06-07,2021-06-07,Bill Sharing
40906174,0,18273,-9255762,2021-06-08,2021-06-08,
40906174,0,11084,-9244678,2021-06-09,2021-06-09,
40906174,312133,0,-9556811,2021-06-09,2021-06-09,Entertainment
40906174,0,465170,-9091641,2021-06-10,2021-06-10,
40906174,0,411730,-8679911,2021-06-10,2021-06-10,
40906174,0,313283,-8366628,2021-06-10,2021-06-10,
40906174,14854,0,-8381482,2021-06-11,2021-06-11,Bill Sharing
40906174,329438,0,-8710920,2021-06-11,2021-06-11,Groceries
40906174,0,487480,-8223440,2021-06-11,2021-06-11,
40906174,477115,0,-8700555,2021-06-12,2021-06-12,Education
40906174,0,378586,-8321969,2021-06-12,2021-06-12,
40906174,0,457706,-7864263,2021-06-13,2021-06-13,
40906174,0,351174,-7513089,2021-06-13,2021-06-13,
40906174,12151,0,-7525240,2021-06-14,2021-06-14,Bill Sharing
40906174,386135,0,-7911375,2021-06-14,2021-06-14,Groceries
40906174,477770,0,-8389145,2021-06-14,2021-06-14,Rent
40906174,0,16029,-8373116,2021-06-15,2021-06-15,
40906174,0,475911,-8799368,2021-06-16,2021-06-16,
40906174,15053,0,-8814421,2021-06-16,2021-06-16,Healthcare
40906174,452422,0,-9266843,2021-06-16,2021-06-16,Education
40906174,0,11085,-9255758,2021-06-17,2021-06-17,
40906174,0,432772,-8822986,2021-06-18,2021-06-18,
40906174,14253,0,-8837239,2021-06-18,2021-06-18,Bill Sharing
40906174,0,464375,-8372864,2021-06-19,2021-06-19,
40906174,17857,0,-8390721,2021-06-19,2021-06-19,Utilities
40906174,489345,0,-8880066,2021-06-20,2021-06-20,Education
40906174,485953,0,-9366019,2021-06-20,2021-06-20,Bill Sharing
40906174,0,354292,-9011727,2021-06-21,2021-06-21,
40906174,18779,0,-9030506,2021-06-21,2021-06-21,Transportation
40906174,15321,0,-9045827,2021-06-21,2021-06-21,Rent
40906174,18193,0,-9064020,2021-06-22,2021-06-22,Utilities
40906174,0,416428,-8647592,2021-06-22,2021-06-22,
40906174,469353,0,-9116945,2021-06-23,2021-06-23,Clothes
40906174,14318,0,-9131263,2021-06-24,2021-06-24,Rent
40906174,18644,0,-9149907,2021-06-25,2021-06-25,Entertainment
40906174,17355,0,-9167262,2021-06-26,2021-06-26,Bill Sharing
40906174,0,419761,-8747501,2021-06-26,2021-06-26,
40906174,10952,0,-8758453,2021-06-27,2021-06-27,Bill Sharing
40906174,10665,0,-8769118,2021-06-27,2021-06-27,Bill Sharing
40906174,12122,0,-8781240,2021-06-27,2021-06-27,Entertainment
40906174,0,476063,-8305177,2021-06-28,2021-06-28,
40906174,0,395429,-7909748,2021-06-28,2021-06-28,
40906174,0,16803,-7892945,2021-06-28,2021-06-28,
40906174,0,14858,-7878087,2021-06-29,2021-06-29,
40906174,0,13605,-7864482,2021-06-29,2021-06-29,
40906174,620062,0,-8261794,2021-06-30,2021-06-30,Healthcare
40906174,381865,0,-8643659,2021-06-30,2021-06-30,Utilities
40906174,0,426548,-8217111,2021-07-01,2021-07-01,
40906174,453208,0,-8670319,2021-07-01,2021-07-01,Education
40906174,17308,0,-8687627,2021-07-02,2021-07-02,Entertainment
40906174,17415,0,-8705042,2021-07-02,2021-07-02,Utilities
40906174,306788,0,-9011830,2021-07-02,2021-07-02,Utilities
40906174,0,520300,-8692685,2021-07-03,2021-07-03,
40906174,0,360520,-8332165,2021-07-04,2021-07-04,
40906174,0,493753,-7838412,2021-07-04,2021-07-04,
40906174,0,382544,-7455868,2021-07-04,2021-07-04,
40906174,483928,0,-7939796,2021-07-05,2021-07-05,Healthcare
40906174,19255,0,-7959051,2021-07-05,2021-07-05,Bill Sharing
40906174,15575,0,-7974626,2021-07-05,2021-07-05,Groceries
40906174,417665,0,-8392291,2021-07-06,2021-07-06,Clothes
40906174,0,487956,-7904335,2021-07-07,2021-07-07,
40906174,331063,0,-8235398,2021-07-07,2021-07-07,Bill Sharing
40906174,300781,0,-8536179,2021-07-08,2021-07-08,Rent
40906174,0,441994,-8094185,2021-07-09,2021-07-09,
40906174,0,345552,-7748633,2021-07-09,2021-07-09,
40906174,0,310827,-7437806,2021-07-09,2021-07-09,
40906174,0,362678,-7075128,2021-07-10,2021-07-10,
40906174,0,487109,-6588019,2021-07-10,2021-07-10,
40906174,0,19466,-6568553,2021-07-10,2021-07-10,
40906174,16306,0,-6584859,2021-07-11,2021-07-11,Transportation
40906174,0,391807,-6193052,2021-07-12,2021-07-12,
40906174,18244,0,-6211296,2021-07-12,2021-07-12,Groceries
40906174,421316,0,-6632612,2021-07-13,2021-07-13,Entertainment
40906174,422500,0,-7055112,2021-07-14,2021-07-14,Healthcare
40906174,0,467386,-6587726,2021-07-14,2021-07-14,
40906174,0,19616,-6568110,2021-07-14,2021-07-14,
40906174,486813,0,-7054923,2021-07-15,2021-07-15,Clothes
40906174,0,436059,-6618864,2021-07-15,2021-07-15,
40906174,474293,0,-7093157,2021-07-15,2021-07-15,Transportation
40906174,0,19596,-7073561,2021-07-16,2021-07-16,
40906174,0,15579,-7057982,2021-07-16,2021-07-16,
40906174,0,467754,-6590228,2021-07-17,2021-07-17,
40906174,368485,0,-6958713,2021-07-18,2021-07-18,Rent
40906174,473083,0,-7431796,2021-07-18,2021-07-18,Transportation
40906174,0,11768,-7420028,2021-07-18,2021-07-18,
40906174,317855,0,-7737883,2021-07-19,2021-07-19,Education
40906174,399362,0,-8137245,2021-07-19,2021-07-19,Utilities
40906174,12486,0,-8149731,2021-07-20,2021-07-20,Rent
40906174,0,16922,-8132809,2021-07-20,2021-07-20,
40906174,0,418824,-7713985,2021-07-21,2021-07-21,
40906174,302360,0,-8016345,2021-07-22,2021-07-22,Groceries
40906174,10660,0,-8027005,2021-07-22,2021-07-22,Bill Sharing
40906174,12923,0,-8039928,2021-07-22,2021-07-22,Education
40906174,0,448976,-8021804,2021-07-23,2021-07-23,
40906174,355800,0,-8377604,2021-07-24,2021-07-24,Transportation
40906174,0,18102,-8359502,2021-07-25,2021-07-25,
40906174,0,325160,-8034342,2021-07-25,2021-07-25,
40906174,14669,0,-8049011,2021-07-25,2021-07-25,Entertainment
40906174,0,351284,-7697727,2021-07-26,2021-07-26,
40906174,0,366805,-7330922,2021-07-27,2021-07-27,
40906174,18240,0,-7349162,2021-07-28,2021-07-28,Utilities
40906174,495521,0,-7844683,2021-07-28,2021-07-28,Bill Sharing
40906174,0,458634,-7386049,2021-07-28,2021-07-28,
40906174,0,439602,-6946447,2021-07-29,2021-07-29,
40906174,0,394226,-6552221,2021-07-29,2021-07-29,
40906174,0,10658,-6541563,2021-07-30,2021-07-30,
40906174,16047,0,-6557610,2021-07-30,2021-07-30,Utilities
40906174,19267,0,-6576877,2021-07-31,2021-07-31,Utilities
40906174,0,461177,-6115700,2021-08-01,2021-08-01,
40906174,373524,0,-6489224,2021-08-01,2021-08-01,Utilities
40906174,0,318868,-6170356,2021-08-02,2021-08-02,
40906174,442860,0,-6613216,2021-08-03,2021-08-03,Utilities
40906174,0,15775,-6597441,2021-08-03,2021-08-03,
40906174,0,16510,-6580931,2021-08-04,2021-08-04,
40906174,10220,0,-6591151,2021-08-04,2021-08-04,Transportation
40906174,0,10447,-6580704,2021-08-05,2021-08-05,
40906174,0,446794,-6133910,2021-08-05,2021-08-05,
40906174,408652,0,-6542562,2021-08-05,2021-08-05,Bill Sharing
40906174,0,10863,-6531699,2021-08-06,2021-08-06,
40906174,0,474325,-6057374,2021-08-06,2021-08-06,
40906174,0,474435,-5582939,2021-08-06,2021-08-06,
40906174,0,500481,-5599326,2021-08-07,2021-08-07,
40906174,0,11918,-5587408,2021-08-08,2021-08-08,
40906174,0,343691,-5243717,2021-08-08,2021-08-08,
40906174,17590,0,-5261307,2021-08-09,2021-08-09,Groceries
40906174,383757,0,-5645064,2021-08-10,2021-08-10,Groceries
40906174,0,12498,-5632566,2021-08-10,2021-08-10,
40906174,0,10499,-5622067,2021-08-10,2021-08-10,
40906174,0,472034,-5150033,2021-08-11,2021-08-11,
40906174,0,315259,-4834774,2021-08-11,2021-08-11,
40906174,0,405997,-4428777,2021-08-12,2021-08-12,
40906174,16347,0,-4445124,2021-08-12,2021-08-12,Transportation
40906174,15206,0,-4460330,2021-08-12,2021-08-12,Rent
40906174,0,13843,-4446487,2021-08-13,2021-08-13,
40906174,0,17563,-4428924,2021-08-13,2021-08-13,
40906174,0,370619,-4058305,2021-08-14,2021-08-14,
40906174,436136,0,-4494441,2021-08-15,2021-08-15,Clothes
40906174,0,449912,-4044529,2021-08-15,2021-08-15,
40906174,457283,0,-4501812,2021-08-15,2021-08-15,Bill Sharing
40906174,14063,0,-4515875,2021-08-16,2021-08-16,Clothes
40906174,11534,0,-4527409,2021-08-16,2021-08-16,Bill Sharing
40906174,0,371572,-4155837,2021-08-16,2021-08-16,
40906174,0,447470,-3708367,2021-08-17,2021-08-17,
40906174,0,19127,-3689240,2021-08-18,2021-08-18,
40906174,0,15233,-3674007,2021-08-19,2021-08-19,
40906174,0,10960,-3663047,2021-08-19,2021-08-19,
40906174,0,13838,-3649209,2021-08-19,2021-08-19,
40906174,0,370208,-3279001,2021-08-20,2021-08-20,
40906174,807311,0,-3262619,2021-08-21,2021-08-21,Education
40906174,0,464805,-2797814,2021-08-21,2021-08-21,
40906174,445951,0,-3243765,2021-08-22,2021-08-22,Utilities
40906174,0,14521,-3229244,2021-08-22,2021-08-22,
40906174,0,450491,-2778753,2021-08-22,2021-08-22,
40906174,310749,0,-3089502,2021-08-23,2021-08-23,Education
40906174,556973,0,-3525742,2021-08-24,2021-08-24,Education
40906174,451688,0,-3977430,2021-08-24,2021-08-24,Bill Sharing
40906174,0,307885,-3669545,2021-08-24,2021-08-24,
40906174,0,450612,-3218933,2021-08-25,2021-08-25,
40906174,0,18067,-3200866,2021-08-25,2021-08-25,
40906174,0,387110,-2813756,2021-08-26,2021-08-26,
40906174,17820,0,-2831576,2021-08-26,2021-08-26,Rent
40906174,471738,0,-3303314,2021-08-26,2021-08-26,Healthcare
40906174,18878,0,-3322192,2021-08-27,2021-08-27,Education
40906174,11195,0,-3333387,2021-08-27,2021-08-27,Utilities
40906174,0,320801,-3012586,2021-08-28,2021-08-28,
40906174,416710,0,-3429296,2021-08-28,2021-08-28,Education
40906174,16575,0,-3445871,2021-08-28,2021-08-28,Education
40906174,488544,0,-3934415,2021-08-29,2021-08-29,Utilities
40906174,341558,0,-4275973,2021-08-29,2021-08-29,Healthcare
40906174,0,364078,-3911895,2021-08-29,2021-08-29,
40906174,0,10488,-3901407,2021-08-30,2021-08-30,
40906174,0,430150,-3471257,2021-08-31,2021-08-31,
40906174,0,406364,-3064893,2021-08-31,2021-08-31,
40906174,0,365587,-2699306,2021-08-31,2021-08-31,
40906174,342491,0,-3041797,2021-09-01,2021-09-01,Entertainment
40906174,0,412832,-2628965,2021-09-01,2021-09-01,
40906174,0,16629,-2612336,2021-09-02,2021-09-02,
40906174,0,382320,-2230016,2021-09-02,2021-09-02,
40906174,482467,0,-2712483,2021-09-02,2021-09-02,Utilities
40906174,0,460119,-2252364,2021-09-03,2021-09-03,
40906174,16636,0,-2269000,2021-09-03,2021-09-03,Entertainment
40906174,385012,0,-2654012,2021-09-04,2021-09-04,Bill Sharing
40906174,471461,0,-3125473,2021-09-05,2021-09-05,Utilities
40906174,478263,0,-3603736,2021-09-05,2021-09-05,Bill Sharing
40906174,472810,0,-4076546,2021-09-06,2021-09-06,Transportation
40906174,0,13463,-4063083,2021-09-06,2021-09-06,
40906174,0,480798,-3582285,2021-09-06,2021-09-06,
40906174,0,306042,-3276243,2021-09-07,2021-09-07,
40906174,0,12957,-3263286,2021-09-07,2021-09-07,
40906174,16849,0,-3280135,2021-09-07,2021-09-07,Utilities
40906174,0,15171,-3264964,2021-09-08,2021-09-08,
40906174,462099,0,-3727063,2021-09-08,2021-09-08,Clothes
40906174,0,305165,-3421898,2021-09-08,2021-09-08,
40906174,0,15440,-3406458,2021-09-09,2021-09-09,
40906174,461976,0,-3868434,2021-09-10,2021-09-10,Clothes
40906174,340707,0,-4209141,2021-09-11,2021-09-11,Clothes
40906174,0,17955,-4191186,2021-09-11,2021-09-11,
40906174,341823,0,-4533009,2021-09-11,2021-09-11,Education
40906174,18868,0,-4551877,2021-09-12,2021-09-12,Groceries
40906174,15884,0,-4567761,2021-09-12,2021-09-12,Utilities
40906174,393783,0,-4961544,2021-09-12,2021-09-12,Transportation
40906174,398760,0,-5360304,2021-09-13,2021-09-13,Education
40906174,343545,0,-5703849,2021-09-14,2021-09-14,Healthcare
40906174,0,14270,-5689579,2021-09-14,2021-09-14,
40906174,0,317918,-5371661,2021-09-15,2021-09-15,
40906174,12872,0,-5384533,2021-09-15,2021-09-15,Rent
40906174,0,16892,-5367641,2021-09-16,2021-09-16,
40906174,306084,0,-5673725,2021-09-17,2021-09-17,Rent
40906174,361593,0,-6035318,2021-09-17,2021-09-17,Rent
40906174,645626,0,-6045508,2021-09-17,2021-09-17,Education
40906174,17971,0,-6063479,2021-09-18,2021-09-18,Education
40906174,0,339448,-5724031,2021-09-19,2021-09-19,
40906174,0,301314,-5422717,2021-09-19,2021-09-19,
40906174,0,450320,-4972397,2021-09-19,2021-09-19,
40906174,0,300217,-4672180,2021-09-20,2021-09-20,
40906174,0,430875,-4241305,2021-09-21,2021-09-21,
40906174,14111,0,-4255416,2021-09-21,2021-09-21,Clothes
40906174,0,513282,-3928902,2021-09-21,2021-09-21,
40906174,0,11008,-3917894,2021-09-22,2021-09-22,
40906174,0,401645,-3516249,2021-09-23,2021-09-23,
40906174,435572,0,-3951821,2021-09-24,2021-09-24,Transportation
40906174,0,368155,-3583666,2021-09-25,2021-09-25,
40906174,12830,0,-3596496,2021-09-25,2021-09-25,Groceries
40906174,0,489442,-3107054,2021-09-26,2021-09-26,
40906174,0,11113,-3095941,2021-09-26,2021-09-26,
40906174,0,492416,-2603525,2021-09-27,2021-09-27,
40906174,559330,0,-2943949,2021-09-28,2021-09-28,Healthcare
40906174,313617,0,-3257566,2021-09-28,2021-09-28,Rent
40906174,315095,0,-3572661,2021-09-29,2021-09-29,Healthcare
40906174,0,10838,-3561823,2021-09-29,2021-09-29,
40906174,0,446244,-3115579,2021-09-29,2021-09-29,
40906174,470092,0,-3585671,2021-09-30,2021-09-30,Clothes
40906174,0,18819,-3566852,2021-10-01,2021-10-01,
40906174,325320,0,-3892172,2021-10-01,2021-10-01,Utilities
40906174,0,16210,-3875962,2021-10-01,2021-10-01,
40906174,19630,0,-3895592,2021-10-02,2021-10-02,Transportation
40906174,0,18306,-3877286,2021-10-02,2021-10-02,
40906174,398403,0,-4275689,2021-10-02,2021-10-02,Clothes
40906174,18187,0,-4293876,2021-10-03,2021-10-03,Clothes
40906174,0,12326,-4281550,2021-10-03,2021-10-03,
40906174,0,376711,-3904839,2021-10-03,2021-10-03,
40906174,18253,0,-3923092,2021-10-04,2021-10-04,Utilities
40906174,0,13868,-3909224,2021-10-04,2021-10-04,
40906174,308536,0,-4217760,2021-10-05,2021-10-05,Education
40906174,483720,0,-4701480,2021-10-05,2021-10-05,Entertainment
40906174,0,12141,-4689339,2021-10-05,2021-10-05,
40906174,0,318739,-4370600,2021-10-06,2021-10-06,
40906174,0,428894,-3941706,2021-10-07,2021-10-07,
40906174,0,15644,-3926062,2021-10-08,2021-10-08,
40906174,0,352748,-3573314,2021-10-08,2021-10-08,
40906174,0,18573,-3554741,2021-10-08,2021-10-08,
40906174,0,471308,-3083433,2021-10-09,2021-10-09,
40906174,0,16308,-3067125,2021-10-09,2021-10-09,
40906174,18088,0,-3085213,2021-10-09,2021-10-09,Bill Sharing
40906174,0,15316,-3069897,2021-10-10,2021-10-10,
40906174,11746,0,-3081643,2021-10-11,2021-10-11,Groceries
40906174,0,11068,-3070575,2021-10-12,2021-10-12,
40906174,0,489593,-2580982,2021-10-12,2021-10-12,
40906174,0,483405,-2097577,2021-10-12,2021-10-12,
40906174,0,387041,-1710536,2021-10-13,2021-10-13,
40906174,0,593208,-2183077,2021-10-13,2021-10-13,
40906174,12481,0,-2195558,2021-10-14,2021-10-14,Clothes
40906174,0,451833,-1743725,2021-10-15,2021-10-15,
40906174,348141,0,-2091866,2021-10-15,2021-10-15,Rent
40906174,0,350653,-1741213,2021-10-15,2021-10-15,
40906174,429915,0,-2171128,2021-10-16,2021-10-16,Groceries
40906174,440248,0,-2611376,2021-10-17,2021-10-17,Healthcare
40906174,13129,0,-2624505,2021-10-17,2021-10-17,Transportation
40906174,368069,0,-2992574,2021-10-17,2021-10-17,Bill Sharing
40906174,0,16537,-2976037,2021-10-18,2021-10-18,
40906174,418710,0,-3394747,2021-10-19,2021-10-19,Transportation
40906174,0,422855,-2971892,2021-10-19,2021-10-19,
40906174,325453,0,-3297345,2021-10-19,2021-10-19,Utilities
40906174,0,19936,-3277409,2021-10-20,2021-10-20,
40906174,0,18470,-3258939,2021-10-20,2021-10-20,
40906174,0,445938,-2813001,2021-10-20,2021-10-20,
40906174,14956,0,-2827957,2021-10-21,2021-10-21,Clothes
40906174,0,14485,-2813472,2021-10-21,2021-10-21,
40906174,17239,0,-2830711,2021-10-21,2021-10-21,Entertainment
40906174,458365,0,-3289076,2021-10-22,2021-10-22,Education
40906174,0,476835,-2812241,2021-10-22,2021-10-22,
40906174,13807,0,-2826048,2021-10-22,2021-10-22,Utilities
40906174,0,630418,-3293067,2021-10-23,2021-10-23,
40906174,0,435373,-2857694,2021-10-23,2021-10-23,
40906174,13226,0,-2870920,2021-10-23,2021-10-23,Healthcare
40906174,0,19680,-2851240,2021-10-24,2021-10-24,
40906174,11830,0,-2863070,2021-10-24,2021-10-24,Education
40906174,468937,0,-3332007,2021-10-25,2021-10-25,Bill Sharing
40906174,464795,0,-3796802,2021-10-26,2021-10-26,Entertainment
40906174,408105,0,-4204907,2021-10-26,2021-10-26,Groceries
40906174,0,370210,-3834697,2021-10-27,2021-10-27,
40906174,0,477721,-3356976,2021-10-27,2021-10-27,
40906174,11097,0,-3368073,2021-10-27,2021-10-27,Groceries
40906174,439950,0,-3808023,2021-10-28,2021-10-28,Bill Sharing
40906174,0,303594,-3504429,2021-10-28,2021-10-28,
40906174,492447,0,-3996876,2021-10-28,2021-10-28,Bill Sharing
40906174,0,404668,-3592208,2021-10-29,2021-10-29,
40906174,0,327119,-3265089,2021-10-30,2021-10-30,
40906174,483414,0,-3748503,2021-10-30,2021-10-30,Bill Sharing
40906174,494372,0,-4242875,2021-10-30,2021-10-30,Education
40906174,19898,0,-4262773,2021-10-31,2021-10-31,Utilities
40906174,0,15681,-4247092,2021-10-31,2021-10-31,
40906174,0,477772,-3769320,2021-10-31,2021-10-31,
40906174,17219,0,-3786539,2021-11-01,2021-11-01,Rent
40906174,0,375720,-3410819,2021-11-02,2021-11-02,
40906174,0,474928,-2935891,2021-11-02,2021-11-02,
40906174,0,357930,-2577961,2021-11-02,2021-11-02,
40906174,15767,0,-2593728,2021-11-03,2021-11-03,Healthcare
40906174,13226,0,-2606954,2021-11-03,2021-11-03,Rent
40906174,0,618898,-2147481,2021-11-03,2021-11-03,
40906174,10858,0,-2158339,2021-11-04,2021-11-04,Education
40906174,14237,0,-2172576,2021-11-04,2021-11-04,Rent
40906174,19418,0,-2191994,2021-11-04,2021-11-04,Utilities
40906174,425935,0,-2617929,2021-11-05,2021-11-05,Entertainment
40906174,305879,0,-2923808,2021-11-06,2021-11-06,Clothes
40906174,18201,0,-2942009,2021-11-06,2021-11-06,Healthcare
40906174,436649,0,-3378658,2021-11-07,2021-11-07,Entertainment
40906174,0,352291,-3026367,2021-11-08,2021-11-08,
40906174,351426,0,-3377793,2021-11-08,2021-11-08,Education
40906174,0,19815,-3357978,2021-11-08,2021-11-08,
40906174,11046,0,-3369024,2021-11-09,2021-11-09,Transportation
40906174,0,14317,-3354707,2021-11-09,2021-11-09,
40906174,372581,0,-3727288,2021-11-10,2021-11-10,Entertainment
40906174,357482,0,-4084770,2021-11-11,2021-11-11,Bill Sharing
40906174,0,961955,-4098307,2021-11-11,2021-11-11,
40906174,0,10941,-4087366,2021-11-11,2021-11-11,
40906174,0,360387,-3726979,2021-11-12,2021-11-12,
40906174,0,12337,-3714642,2021-11-12,2021-11-12,
40906174,0,17239,-3697403,2021-11-13,2021-11-13,
40906174,0,12843,-3684560,2021-11-13,2021-11-13,
40906174,489581,0,-4174141,2021-11-14,2021-11-14,Healthcare
40906174,352082,0,-4526223,2021-11-14,2021-11-14,Groceries
40906174,423935,0,-4950158,2021-11-14,2021-11-14,Entertainment
40906174,0,397932,-4552226,2021-11-15,2021-11-15,
40906174,0,19438,-4532788,2021-11-16,2021-11-16,
40906174,0,17009,-4515779,2021-11-16,2021-11-16,
40906174,413775,0,-4929554,2021-11-16,2021-11-16,Rent
40906174,0,19457,-4910097,2021-11-17,2021-11-17,
40906174,0,11873,-4898224,2021-11-17,2021-11-17,
40906174,406692,0,-5304916,2021-11-18,2021-11-18,Education
40906174,433013,0,-5737929,2021-11-18,2021-11-18,Transportation
40906174,418374,0,-6156303,2021-11-19,2021-11-19,Healthcare
40906174,19333,0,-6175636,2021-11-20,2021-11-20,Healthcare
40906174,17095,0,-6192731,2021-11-20,2021-11-20,Utilities
40906174,0,18732,-6173999,2021-11-20,2021-11-20,
40906174,0,401268,-5772731,2021-11-21,2021-11-21,
40906174,479320,0,-6252051,2021-11-22,2021-11-22,Education
40906174,0,10017,-6242034,2021-11-22,2021-11-22,
40906174,0,456890,-5785144,2021-11-23,2021-11-23,
40906174,477057,0,-6262201,2021-11-24,2021-11-24,Healthcare
40906174,12540,0,-6274741,2021-11-24,2021-11-24,Entertainment
40906174,16712,0,-6291453,2021-11-24,2021-11-24,Rent
40906174,19572,0,-6311025,2021-11-25,2021-11-25,Transportation
40906174,0,366551,-5944474,2021-11-26,2021-11-26,
40906174,17223,0,-5961697,2021-11-26,2021-11-26,Bill Sharing
40906174,0,396610,-5565087,2021-11-27,2021-11-27,
40906174,0,14892,-5550195,2021-11-27,2021-11-27,
40906174,0,313582,-5236613,2021-11-27,2021-11-27,
40906174,0,16776,-5219837,2021-11-28,2021-11-28,
40906174,0,395998,-4823839,2021-11-28,2021-11-28,
40906174,0,366963,-4456876,2021-11-29,2021-11-29,
40906174,0,717060,-4442532,2021-11-29,2021-11-29,
40906174,0,365166,-4077366,2021-11-30,2021-11-30,
40906174,447392,0,-4524758,2021-11-30,2021-11-30,Utilities
40906174,312501,0,-4837259,2021-12-01,2021-12-01,Groceries
40906174,0,12678,-4824581,2021-12-01,2021-12-01,
40906174,0,383917,-4440664,2021-12-01,2021-12-01,
40906174,16771,0,-4457435,2021-12-02,2021-12-02,Bill Sharing
40906174,0,13112,-4444323,2021-12-02,2021-12-02,
40906174,357096,0,-4801419,2021-12-03,2021-12-03,Entertainment
40906174,0,331174,-4470245,2021-12-04,2021-12-04,
40906174,469579,0,-4939824,2021-12-04,2021-12-04,Healthcare
40906174,528751,0,-5348544,2021-12-04,2021-12-04,Healthcare
40906174,0,12473,-5336071,2021-12-05,2021-12-05,
40906174,16492,0,-5352563,2021-12-05,2021-12-05,Utilities
40906174,14055,0,-5366618,2021-12-05,2021-12-05,Healthcare
40906174,19295,0,-5385913,2021-12-06,2021-12-06,Transportation
40906174,0,366657,-5019256,2021-12-06,2021-12-06,
40906174,406893,0,-5426149,2021-12-06,2021-12-06,Education
40906174,0,12383,-5413766,2021-12-07,2021-12-07,
40906174,356520,0,-5770286,2021-12-08,2021-12-08,Clothes
40906174,0,372610,-5397676,2021-12-08,2021-12-08,
40906174,10220,0,-5407896,2021-12-09,2021-12-09,Utilities
40906174,14693,0,-5422589,2021-12-09,2021-12-09,Healthcare
40906174,352750,0,-5775339,2021-12-09,2021-12-09,Rent
40906174,0,486985,-5288354,2021-12-10,2021-12-10,
40906174,318265,0,-5606619,2021-12-10,2021-12-10,Bill Sharing
40906174,0,13335,-5593284,2021-12-11,2021-12-11,
40906174,0,15515,-5577769,2021-12-12,2021-12-12,
40906174,376417,0,-5954186,2021-12-12,2021-12-12,Education
40906174,0,392700,-5561486,2021-12-13,2021-12-13,
40906174,0,324591,-5236895,2021-12-14,2021-12-14,
40906174,0,12824,-5224071,2021-12-14,2021-12-14,
40906174,314856,0,-5538927,2021-12-15,2021-12-15,Transportation
40906174,0,10373,-5528554,2021-12-16,2021-12-16,
40906174,0,19761,-5508793,2021-12-17,2021-12-17,
40906174,0,490016,-5018777,2021-12-18,2021-12-18,
40906174,0,19838,-4998939,2021-12-19,2021-12-19,
40906174,0,14449,-4984490,2021-12-19,2021-12-19,
40906174,10263,0,-4994753,2021-12-19,2021-12-19,Bill Sharing
40906174,0,597597,-4539069,2021-12-20,2021-12-20,
40906174,0,444592,-4094477,2021-12-20,2021-12-20,
40906174,0,486355,-3608122,2021-12-20,2021-12-20,
40906174,463149,0,-4071271,2021-12-21,2021-12-21,Healthcare
40906174,0,457844,-3613427,2021-12-21,2021-12-21,
40906174,319563,0,-3932990,2021-12-21,2021-12-21,Bill Sharing
40906174,0,19836,-3913154,2021-12-22,2021-12-22,
40906174,0,18923,-3894231,2021-12-23,2021-12-23,
40906174,17202,0,-3911433,2021-12-23,2021-12-23,Entertainment
40906174,16422,0,-3927855,2021-12-24,2021-12-24,Entertainment
40906174,413418,0,-4341273,2021-12-25,2021-12-25,Utilities
40906174,346124,0,-4687397,2021-12-25,2021-12-25,Clothes
40906174,448151,0,-5135548,2021-12-26,2021-12-26,Groceries
40906174,17566,0,-5153114,2021-12-26,2021-12-26,Entertainment
40906174,0,356855,-4796259,2021-12-27,2021-12-27,
40906174,0,362248,-4434011,2021-12-27,2021-12-27,
40906174,12845,0,-4446856,2021-12-28,2021-12-28,Healthcare
40906174,16159,0,-4463015,2021-12-28,2021-12-28,Clothes
40906174,347270,0,-4810285,2021-12-28,2021-12-28,Rent
40906174,0,13592,-4796693,2021-12-29,2021-12-29,
40906174,469957,0,-5266650,2021-12-29,2021-12-29,Transportation
40906174,332326,0,-5598976,2021-12-29,2021-12-29,Clothes
40906174,375120,0,-5974096,2021-12-30,2021-12-30,Bill Sharing
40906174,0,11712,-5962384,2021-12-31,2021-12-31,
40906174,10611,0,-5972995,2021-12-31,2021-12-31,Groceries
40906174,0,351951,-5621044,2021-12-31,2021-12-31,
40906174,438507,0,-6059551,2022-01-01,2022-01-01,Transportation
40906174,0,18792,-6040759,2022-01-01,2022-01-01,
40906174,0,311880,-5728879,2022-01-01,2022-01-01,
40906174,300317,0,-6029196,2022-01-02,2022-01-02,Transportation
40906174,439777,0,-6468973,2022-01-02,2022-01-02,Clothes
40906174,0,18177,-6450796,2022-01-03,2022-01-03,
40906174,0,904246,-6435496,2022-01-03,2022-01-03,
40906174,312186,0,-6747682,2022-01-03,2022-01-03,Transportation
40906174,327724,0,-7075406,2022-01-04,2022-01-04,Clothes
40906174,0,351938,-6723468,2022-01-05,2022-01-05,
40906174,0,15784,-6707684,2022-01-06,2022-01-06,
40906174,0,12048,-6695636,2022-01-07,2022-01-07,
40906174,0,465092,-6230544,2022-01-07,2022-01-07,
40906174,367769,0,-6598313,2022-01-07,2022-01-07,Transportation
40906174,11248,0,-6609561,2022-01-08,2022-01-08,Utilities
40906174,0,12924,-6596637,2022-01-08,2022-01-08,
40906174,13052,0,-6609689,2022-01-09,2022-01-09,Transportation
40906174,0,476169,-6133520,2022-01-10,2022-01-10,
40906174,480050,0,-6613570,2022-01-11,2022-01-11,Healthcare
40906174,459854,0,-7073424,2022-01-11,2022-01-11,Bill Sharing
40906174,0,12354,-7061070,2022-01-11,2022-01-11,
40906174,497670,0,-7558740,2022-01-12,2022-01-12,Education
40906174,0,496283,-7062457,2022-01-13,2022-01-13,
40906174,0,473514,-6588943,2022-01-13,2022-01-13,
40906174,405044,0,-6608388,2022-01-14,2022-01-14,Healthcare
40906174,0,11990,-6596398,2022-01-14,2022-01-14,
40906174,0,10281,-6586117,2022-01-15,2022-01-15,
40906174,315804,0,-6901921,2022-01-15,2022-01-15,Groceries
40906174,0,11338,-6890583,2022-01-16,2022-01-16,
40906174,10262,0,-6900845,2022-01-16,2022-01-16,Education
40906174,0,11762,-6889083,2022-01-16,2022-01-16,
40906174,351778,0,-7240861,2022-01-17,2022-01-17,Healthcare
40906174,464797,0,-7605331,2022-01-18,2022-01-18,Education
40906174,18855,0,-7624186,2022-01-19,2022-01-19,Groceries
40906174,16650,0,-7640836,2022-01-20,2022-01-20,Entertainment
40906174,399578,0,-8040414,2022-01-21,2022-01-21,Clothes
40906174,16405,0,-8056819,2022-01-21,2022-01-21,Bill Sharing
40906174,0,405312,-7651507,2022-01-21,2022-01-21,
40906174,0,481171,-7170336,2022-01-22,2022-01-22,
40906174,421605,0,-7591941,2022-01-22,2022-01-22,Utilities
40906174,0,307718,-7284223,2022-01-23,2022-01-23,
40906174,19987,0,-7304210,2022-01-23,2022-01-23,Utilities
40906174,0,391668,-6912542,2022-01-24,2022-01-24,
40906174,17569,0,-6930111,2022-01-25,2022-01-25,Rent
40906174,500209,0,-7274817,2022-01-25,2022-01-25,Healthcare
40906174,327316,0,-7602133,2022-01-26,2022-01-26,Education
40906174,469691,0,-8071824,2022-01-26,2022-01-26,Utilities
40906174,450616,0,-8522440,2022-01-26,2022-01-26,Entertainment
40906174,374735,0,-8897175,2022-01-27,2022-01-27,Utilities
40906174,14445,0,-8911620,2022-01-27,2022-01-27,Entertainment
40906174,0,14728,-8896892,2022-01-28,2022-01-28,
40906174,0,495650,-8401242,2022-01-28,2022-01-28,
40906174,0,10218,-8391024,2022-01-29,2022-01-29,
40906174,0,357134,-8033890,2022-01-29,2022-01-29,
40906174,15837,0,-8049727,2022-01-29,2022-01-29,Clothes
40906174,0,496265,-7553462,2022-01-30,2022-01-30,
40906174,14668,0,-7568130,2022-01-31,2022-01-31,Healthcare
40906174,0,467327,-7100803,2022-02-01,2022-02-01,
40906174,10730,0,-7111533,2022-02-01,2022-02-01,Groceries
40906174,0,482253,-6629280,2022-02-02,2022-02-02,
40906174,784814,0,-6644110,2022-02-03,2022-02-03,Education
40906174,16583,0,-6660693,2022-02-03,2022-02-03,Entertainment
40906174,0,379385,-6281308,2022-02-04,2022-02-04,
40906174,17405,0,-6298713,2022-02-04,2022-02-04,Rent
40906174,0,12814,-6285899,2022-02-05,2022-02-05,
40906174,0,11746,-6274153,2022-02-05,2022-02-05,
40906174,467660,0,-6741813,2022-02-06,2022-02-06,Clothes
40906174,0,471914,-6269899,2022-02-07,2022-02-07,
40906174,0,381706,-5888193,2022-02-07,2022-02-07,
40906174,0,341374,-5546819,2022-02-08,2022-02-08,
40906174,0,15462,-5531357,2022-02-08,2022-02-08,
40906174,18937,0,-5550294,2022-02-08,2022-02-08,Groceries
40906174,490850,0,-6041144,2022-02-09,2022-02-09,Transportation
40906174,0,338269,-5702875,2022-02-10,2022-02-10,
40906174,13034,0,-5715909,2022-02-10,2022-02-10,Clothes
40906174,10988,0,-5726897,2022-02-10,2022-02-10,Rent
40906174,16540,0,-5743437,2022-02-11,2022-02-11,Utilities
40906174,17215,0,-5760652,2022-02-12,2022-02-12,Entertainment
40906174,0,319285,-5441367,2022-02-13,2022-02-13,
40906174,17771,0,-5459138,2022-02-13,2022-02-13,Entertainment
40906174,0,16777,-5442361,2022-02-14,2022-02-14,
40906174,12595,0,-5454956,2022-02-14,2022-02-14,Groceries
40906174,430889,0,-5885845,2022-02-14,2022-02-14,Education
40906174,0,10456,-5875389,2022-02-15,2022-02-15,
40906174,13690,0,-5889079,2022-02-15,2022-02-15,Education
40906174,433888,0,-5899921,2022-02-16,2022-02-16,Healthcare
40906174,374096,0,-6274017,2022-02-16,2022-02-16,Bill Sharing
40906174,0,347340,-5926677,2022-02-17,2022-02-17,
40906174,0,479607,-5447070,2022-02-18,2022-02-18,
40906174,307352,0,-5754422,2022-02-18,2022-02-18,Groceries
40906174,0,429968,-5324454,2022-02-19,2022-02-19,
40906174,0,18787,-5305667,2022-02-19,2022-02-19,
40906174,0,444849,-4860818,2022-02-20,2022-02-20,
40906174,449387,0,-5172590,2022-02-20,2022-02-20,Education
40906174,12512,0,-5185102,2022-02-20,2022-02-20,Entertainment
40906174,0,15259,-5169843,2022-02-21,2022-02-21,
40906174,0,13944,-5155899,2022-02-22,2022-02-22,
40906174,354738,0,-5510637,2022-02-22,2022-02-22,Bill Sharing
40906174,437670,0,-5948307,2022-02-22,2022-02-22,Entertainment
40906174,0,458038,-5490269,2022-02-23,2022-02-23,
40906174,0,358331,-5131938,2022-02-24,2022-02-24,
40906174,0,303525,-4828413,2022-02-24,2022-02-24,
40906174,441556,0,-5269969,2022-02-25,2022-02-25,Entertainment
40906174,0,359322,-4910647,2022-02-26,2022-02-26,
40906174,411313,0,-5321960,2022-02-26,2022-02-26,Bill Sharing
40906174,0,15435,-5306525,2022-02-26,2022-02-26,
40906174,0,380973,-4925552,2022-02-27,2022-02-27,
40906174,393341,0,-5318893,2022-02-27,2022-02-27,Rent
40906174,381467,0,-5700360,2022-02-27,2022-02-27,Utilities
40906174,0,482993,-5217367,2022-02-28,2022-02-28,
40906174,0,329628,-4887739,2022-02-28,2022-02-28,
40906174,312772,0,-5200511,2022-03-01,2022-03-01,Groceries
40906174,0,11351,-5189160,2022-03-02,2022-03-02,
40906174,0,470166,-4718994,2022-03-02,2022-03-02,
40906174,0,16555,-4702439,2022-03-03,2022-03-03,
40906174,0,435960,-4266479,2022-03-04,2022-03-04,
40906174,0,15755,-4250724,2022-03-04,2022-03-04,
40906174,0,392863,-3857861,2022-03-05,2022-03-05,
40906174,16041,0,-3873902,2022-03-06,2022-03-06,Education
40906174,465662,0,-4339564,2022-03-06,2022-03-06,Utilities
40906174,393233,0,-4732797,2022-03-06,2022-03-06,Bill Sharing
40906174,0,452176,-4720697,2022-03-07,2022-03-07,
40906174,0,411687,-4309010,2022-03-07,2022-03-07,
40906174,0,479028,-4328964,2022-03-08,2022-03-08,
40906174,333901,0,-4662865,2022-03-09,2022-03-09,Healthcare
40906174,14127,0,-4676992,2022-03-09,2022-03-09,Education
40906174,471719,0,-5148711,2022-03-09,2022-03-09,Groceries
40906174,461438,0,-5610149,2022-03-10,2022-03-10,Rent
40906174,15824,0,-5625973,2022-03-11,2022-03-11,Healthcare
40906174,0,16219,-5609754,2022-03-12,2022-03-12,
40906174,309573,0,-5919327,2022-03-12,2022-03-12,Education
40906174,0,13140,-5906187,2022-03-13,2022-03-13,
40906174,0,587104,-5919873,2022-03-13,2022-03-13,
40906174,476539,0,-6396412,2022-03-14,2022-03-14,Education
40906174,0,18719,-6377693,2022-03-14,2022-03-14,
40906174,0,435172,-5942521,2022-03-14,2022-03-14,
40906174,19465,0,-5961986,2022-03-15,2022-03-15,Groceries
40906174,304153,0,-6266139,2022-03-16,2022-03-16,Education
40906174,355175,0,-6621314,2022-03-16,2022-03-16,Bill Sharing
40906174,0,12048,-6609266,2022-03-17,2022-03-17,
40906174,0,340131,-6269135,2022-03-17,2022-03-17,
40906174,353825,0,-6622960,2022-03-18,2022-03-18,Rent
40906174,13067,0,-6636027,2022-03-19,2022-03-19,Transportation
40906174,419189,0,-7055216,2022-03-19,2022-03-19,Entertainment
40906174,433656,0,-7488872,2022-03-19,2022-03-19,Clothes
40906174,434269,0,-7923141,2022-03-20,2022-03-20,Bill Sharing
40906174,0,460368,-7462773,2022-03-20,2022-03-20,
40906174,0,307393,-7155380,2022-03-21,2022-03-21,
40906174,10099,0,-7165479,2022-03-22,2022-03-22,Rent
40906174,492389,0,-7657868,2022-03-23,2022-03-23,Groceries
40906174,0,303475,-7354393,2022-03-23,2022-03-23,
40906174,0,14749,-7339644,2022-03-24,2022-03-24,
40906174,0,329440,-7010204,2022-03-25,2022-03-25,
40906174,0,403943,-6606261,2022-03-25,2022-03-25,
40906174,10154,0,-6616415,2022-03-26,2022-03-26,Transportation
40906174,10268,0,-6626683,2022-03-26,2022-03-26,Groceries
40906174,0,371987,-6254696,2022-03-26,2022-03-26,
40906174,11531,0,-6266227,2022-03-27,2022-03-27,Transportation
40906174,18722,0,-6284949,2022-03-27,2022-03-27,Entertainment
40906174,458625,0,-6743574,2022-03-27,2022-03-27,Healthcare
40906174,11509,0,-6755083,2022-03-28,2022-03-28,Groceries
40906174,0,328746,-6426337,2022-03-28,2022-03-28,
40906174,15891,0,-6442228,2022-03-29,2022-03-29,Transportation
40906174,0,455567,-5986661,2022-03-29,2022-03-29,
40906174,18492,0,-6005153,2022-03-29,2022-03-29,Utilities
40906174,373006,0,-6378159,2022-03-30,2022-03-30,Healthcare
40906174,0,388764,-5989395,2022-03-30,2022-03-30,
40906174,368104,0,-6357499,2022-03-30,2022-03-30,Healthcare
40906174,453648,0,-6811147,2022-03-31,2022-03-31,Rent
40906174,452622,0,-7263769,2022-04-01,2022-04-01,Bill Sharing
40906174,17442,0,-7281211,2022-04-01,2022-04-01,Entertainment
40906174,18739,0,-7299950,2022-04-01,2022-04-01,Healthcare
40906174,14625,0,-7314575,2022-04-02,2022-04-02,Healthcare
40906174,12693,0,-7327268,2022-04-02,2022-04-02,Utilities
40906174,0,368033,-6959235,2022-04-02,2022-04-02,
40906174,0,448860,-6510375,2022-04-03,2022-04-03,
40906174,16845,0,-6527220,2022-04-03,2022-04-03,Utilities
40906174,0,313751,-6213469,2022-04-03,2022-04-03,
40906174,0,304540,-5908929,2022-04-04,2022-04-04,
40906174,302783,0,-6211712,2022-04-05,2022-04-05,Transportation
40906174,16977,0,-6228689,2022-04-06,2022-04-06,Clothes
40906174,0,330372,-5898317,2022-04-07,2022-04-07,
40906174,19355,0,-5917672,2022-04-08,2022-04-08,Bill Sharing
40906174,402609,0,-6320281,2022-04-08,2022-04-08,Entertainment
40906174,383637,0,-6703918,2022-04-08,2022-04-08,Transportation
40906174,0,16349,-6687569,2022-04-09,2022-04-09,
40906174,0,13712,-6673857,2022-04-09,2022-04-09,
40906174,401369,0,-7075226,2022-04-09,2022-04-09,Clothes
40906174,498500,0,-7573726,2022-04-10,2022-04-10,Clothes
40906174,503350,0,-8013235,2022-04-10,2022-04-10,Education
40906174,473872,0,-8487107,2022-04-11,2022-04-11,Transportation
40906174,15907,0,-8503014,2022-04-11,2022-04-11,Rent
40906174,0,394688,-8108326,2022-04-11,2022-04-11,
40906174,12543,0,-8120869,2022-04-12,2022-04-12,Rent
40906174,0,14847,-8106022,2022-04-13,2022-04-13,
40906174,455104,0,-8561126,2022-04-13,2022-04-13,Groceries
40906174,0,15901,-8545225,2022-04-13,2022-04-13,
40906174,0,435396,-8109829,2022-04-14,2022-04-14,
40906174,15621,0,-8125450,2022-04-14,2022-04-14,Rent
40906174,423085,0,-8548535,2022-04-15,2022-04-15,Healthcare
40906174,17005,0,-8565540,2022-04-15,2022-04-15,Rent
40906174,379582,0,-8945122,2022-04-15,2022-04-15,Groceries
40906174,480903,0,-9426025,2022-04-16,2022-04-16,Groceries
40906174,0,406821,-9019204,2022-04-17,2022-04-17,
40906174,0,342344,-8676860,2022-04-18,2022-04-18,
40906174,360335,0,-9037195,2022-04-18,2022-04-18,Bill Sharing
40906174,0,309947,-8727248,2022-04-19,2022-04-19,
40906174,994607,0,-8292280,2022-04-19,2022-04-19,Healthcare
40906174,0,489622,-7802658,2022-04-20,2022-04-20,
40906174,0,375808,-7426850,2022-04-20,2022-04-20,
40906174,335953,0,-7762803,2022-04-20,2022-04-20,Entertainment
40906174,404963,0,-8167766,2022-04-21,2022-04-21,Groceries
40906174,0,345903,-7821863,2022-04-22,2022-04-22,
40906174,0,316753,-7505110,2022-04-22,2022-04-22,
40906174,0,329405,-7175705,2022-04-22,2022-04-22,
40906174,0,392420,-6783285,2022-04-23,2022-04-23,
40906174,631668,0,-6290729,2022-04-24,2022-04-24,Education
40906174,323769,0,-6614498,2022-04-24,2022-04-24,Transportation
40906174,13135,0,-6627633,2022-04-25,2022-04-25,Utilities
40906174,430157,0,-7057790,2022-04-25,2022-04-25,Utilities
40906174,0,18565,-7039225,2022-04-26,2022-04-26,
40906174,11386,0,-7050611,2022-04-27,2022-04-27,Clothes
40906174,0,454476,-6596135,2022-04-27,2022-04-27,
40906174,0,331179,-6264956,2022-04-28,2022-04-28,
40906174,433278,0,-6698234,2022-04-29,2022-04-29,Transportation
40906174,0,10584,-6687650,2022-04-30,2022-04-30,
40906174,0,14181,-6673469,2022-05-01,2022-05-01,
40906174,0,18616,-6654853,2022-05-01,2022-05-01,
40906174,411866,0,-7066719,2022-05-01,2022-05-01,Education
40906174,0,12834,-7053885,2022-05-02,2022-05-02,
40906174,16785,0,-7070670,2022-05-02,2022-05-02,Rent
40906174,18521,0,-7089191,2022-05-02,2022-05-02,Rent
40906174,0,363522,-6725669,2022-05-03,2022-05-03,
40906174,0,327114,-6398555,2022-05-03,2022-05-03,
40906174,0,18334,-6380221,2022-05-04,2022-05-04,
40906174,13019,0,-6393240,2022-05-05,2022-05-05,Bill Sharing
40906174,449665,0,-6842905,2022-05-06,2022-05-06,Healthcare
40906174,0,436093,-6406812,2022-05-07,2022-05-07,
40906174,360957,0,-6767769,2022-05-08,2022-05-08,Healthcare
40906174,490612,0,-7258381,2022-05-09,2022-05-09,Clothes
40906174,0,458090,-6800291,2022-05-10,2022-05-10,
40906174,0,488564,-6311727,2022-05-10,2022-05-10,
40906174,0,405069,-5906658,2022-05-10,2022-05-10,
40906174,0,10549,-5896109,2022-05-11,2022-05-11,
40906174,479308,0,-6375417,2022-05-12,2022-05-12,Entertainment
40906174,0,19432,-6355985,2022-05-12,2022-05-12,
40906174,0,335359,-6020626,2022-05-12,2022-05-12,
40906174,0,10353,-6010273,2022-05-13,2022-05-13,
40906174,498029,0,-6508302,2022-05-13,2022-05-13,Rent
40906174,554707,0,-6496420,2022-05-13,2022-05-13,Education
40906174,0,16772,-6479648,2022-05-14,2022-05-14,
40906174,666886,0,-6079368,2022-05-14,2022-05-14,Healthcare
40906174,17317,0,-6096685,2022-05-15,2022-05-15,Healthcare
40906174,0,307076,-5789609,2022-05-15,2022-05-15,
40906174,18183,0,-5807792,2022-05-16,2022-05-16,Utilities
40906174,474233,0,-6282025,2022-05-16,2022-05-16,Education
40906174,0,381824,-5900201,2022-05-16,2022-05-16,
40906174,417174,0,-6317375,2022-05-17,2022-05-17,Entertainment
40906174,0,437243,-5880132,2022-05-17,2022-05-17,
40906174,0,14187,-5865945,2022-05-17,2022-05-17,
40906174,0,379646,-5486299,2022-05-18,2022-05-18,
40906174,362576,0,-5848875,2022-05-18,2022-05-18,Rent
40906174,12684,0,-5861559,2022-05-19,2022-05-19,Transportation
40906174,303358,0,-6164917,2022-05-20,2022-05-20,Education
40906174,375509,0,-6540426,2022-05-20,2022-05-20,Healthcare
40906174,363363,0,-6903789,2022-05-20,2022-05-20,Bill Sharing
40906174,327147,0,-7230936,2022-05-21,2022-05-21,Utilities
40906174,0,343104,-6887832,2022-05-21,2022-05-21,
40906174,520169,0,-6870794,2022-05-21,2022-05-21,Education
40906174,0,19031,-6851763,2022-05-22,2022-05-22,
40906174,14717,0,-6866480,2022-05-22,2022-05-22,Bill Sharing
40906174,367876,0,-7234356,2022-05-22,2022-05-22,Bill Sharing
40906174,375002,0,-7609358,2022-05-23,2022-05-23,Entertainment
40906174,0,11763,-7597595,2022-05-23,2022-05-23,
40906174,14319,0,-7611914,2022-05-24,2022-05-24,Groceries
40906174,0,481121,-7130793,2022-05-25,2022-05-25,
40906174,321461,0,-7452254,2022-05-25,2022-05-25,Utilities
40906174,426235,0,-7878489,2022-05-26,2022-05-26,Utilities
40906174,470669,0,-8349158,2022-05-26,2022-05-26,Groceries
40906174,17740,0,-8366898,2022-05-26,2022-05-26,Clothes
40906174,0,10802,-8356096,2022-05-27,2022-05-27,
40906174,11975,0,-8368071,2022-05-27,2022-05-27,Rent
40906174,0,332401,-8035670,2022-05-27,2022-05-27,
40906174,0,15482,-8020188,2022-05-28,2022-05-28,
40906174,0,10440,-8009748,2022-05-28,2022-05-28,
40906174,0,498904,-7510844,2022-05-28,2022-05-28,
40906174,447555,0,-7958399,2022-05-29,2022-05-29,Healthcare
40906174,19239,0,-7977638,2022-05-30,2022-05-30,Transportation
40906174,430233,0,-8407871,2022-05-30,2022-05-30,Bill Sharing
40906174,319885,0,-8727756,2022-05-30,2022-05-30,Bill Sharing
40906174,402449,0,-9130205,2022-05-31,2022-05-31,Rent
40906174,465556,0,-9595761,2022-05-31,2022-05-31,Rent
40906174,473496,0,-10069257,2022-06-01,2022-06-01,Utilities
40906174,0,12868,-10056389,2022-06-01,2022-06-01,
40906174,10713,0,-10067102,2022-06-01,2022-06-01,Groceries
40906174,0,15390,-10051712,2022-06-02,2022-06-02,
40906174,10363,0,-10062075,2022-06-03,2022-06-03,Utilities
40906174,17491,0,-10079566,2022-06-03,2022-06-03,Groceries
40906174,519832,0,-10095178,2022-06-03,2022-06-03,Education
40906174,0,459921,-9635257,2022-06-04,2022-06-04,
40906174,19798,0,-9655055,2022-06-05,2022-06-05,Entertainment
40906174,0,325187,-9329868,2022-06-05,2022-06-05,
40906174,15314,0,-9345182,2022-06-06,2022-06-06,Healthcare
40906174,0,18051,-9327131,2022-06-06,2022-06-06,
40906174,0,351872,-8975259,2022-06-07,2022-06-07,
40906174,0,423451,-8551808,2022-06-08,2022-06-08,
40906174,0,10614,-8541194,2022-06-08,2022-06-08,
40906174,0,17487,-8523707,2022-06-09,2022-06-09,
40906174,11475,0,-8535182,2022-06-09,2022-06-09,Transportation
40906174,12340,0,-8547522,2022-06-09,2022-06-09,Transportation
40906174,0,375975,-8171547,2022-06-10,2022-06-10,
40906174,0,315209,-7856338,2022-06-10,2022-06-10,
40906174,0,438778,-7417560,2022-06-11,2022-06-11,
40906174,10935,0,-7428495,2022-06-11,2022-06-11,Rent
40906174,341700,0,-7770195,2022-06-11,2022-06-11,Transportation
40906174,0,813705,-8108073,2022-06-12,2022-06-12,
40906174,0,10101,-8097972,2022-06-12,2022-06-12,
40906174,0,18042,-8079930,2022-06-12,2022-06-12,
40906174,0,431344,-7648586,2022-06-13,2022-06-13,
40906174,0,386238,-7262348,2022-06-13,2022-06-13,
40906174,18049,0,-7280397,2022-06-14,2022-06-14,Entertainment
40906174,17948,0,-7298345,2022-06-14,2022-06-14,Clothes
40906174,326945,0,-7625290,2022-06-15,2022-06-15,Bill Sharing
40906174,0,13392,-7611898,2022-06-15,2022-06-15,
40906174,0,10056,-7601842,2022-06-15,2022-06-15,
40906174,0,370763,-7231079,2022-06-16,2022-06-16,
40906174,0,380939,-6850140,2022-06-16,2022-06-16,
40906174,0,19486,-6830654,2022-06-16,2022-06-16,
40906174,393359,0,-7224013,2022-06-17,2022-06-17,Rent
40906174,458001,0,-7682014,2022-06-17,2022-06-17,Clothes
40906174,0,19269,-7662745,2022-06-17,2022-06-17,
40906174,0,14145,-7648600,2022-06-18,2022-06-18,
40906174,0,18398,-7630202,2022-06-18,2022-06-18,
40906174,362017,0,-7992219,2022-06-18,2022-06-18,Utilities
40906174,0,467501,-7524718,2022-06-19,2022-06-19,
40906174,309399,0,-7834117,2022-06-19,2022-06-19,Clothes
40906174,16846,0,-7850963,2022-06-20,2022-06-20,Groceries
40906174,17948,0,-7868911,2022-06-20,2022-06-20,Healthcare
40906174,439395,0,-8308306,2022-06-21,2022-06-21,Healthcare
40906174,428086,0,-8736392,2022-06-21,2022-06-21,Education
40906174,0,494913,-8241479,2022-06-22,2022-06-22,
40906174,406538,0,-8648017,2022-06-22,2022-06-22,Rent
40906174,0,359309,-8288708,2022-06-22,2022-06-22,
40906174,15483,0,-8304191,2022-06-23,2022-06-23,Education
40906174,404483,0,-8708674,2022-06-23,2022-06-23,Healthcare
40906174,14832,0,-8723506,2022-06-23,2022-06-23,Healthcare
40906174,461294,0,-9197529,2022-06-24,2022-06-24,Education
40906174,0,19895,-9177634,2022-06-25,2022-06-25,
40906174,0,14416,-9163218,2022-06-25,2022-06-25,
40906174,0,376492,-8786726,2022-06-25,2022-06-25,
40906174,310250,0,-9096976,2022-06-26,2022-06-26,Utilities
40906174,0,18778,-9078198,2022-06-26,2022-06-26,
40906174,0,331537,-8746661,2022-06-26,2022-06-26,
40906174,485693,0,-9232354,2022-06-27,2022-06-27,Utilities
40906174,0,360173,-8872181,2022-06-28,2022-06-28,
40906174,427404,0,-9299585,2022-06-28,2022-06-28,Groceries
40906174,0,950015,-8898427,2022-06-28,2022-06-28,
40906174,18626,0,-8917053,2022-06-29,2022-06-29,Transportation
40906174,0,448563,-8468490,2022-06-29,2022-06-29,
40906174,0,474437,-7994053,2022-06-30,2022-06-30,
40906174,432787,0,-8426840,2022-06-30,2022-06-30,Education
40906174,12854,0,-8439694,2022-06-30,2022-06-30,Bill Sharing
40906174,16305,0,-8455999,2022-07-01,2022-07-01,Rent
40906174,0,10122,-8445877,2022-07-01,2022-07-01,
40906174,0,489698,-7956179,2022-07-02,2022-07-02,
40906174,0,420495,-7535684,2022-07-02,2022-07-02,
40906174,0,436887,-7098797,2022-07-03,2022-07-03,
40906174,0,488886,-6609911,2022-07-03,2022-07-03,
40906174,405539,0,-7015450,2022-07-03,2022-07-03,Healthcare
40906174,422704,0,-7438154,2022-07-04,2022-07-04,Bill Sharing
40906174,307824,0,-7745978,2022-07-05,2022-07-05,Transportation
40906174,356455,0,-8102433,2022-07-05,2022-07-05,Utilities
40906174,323741,0,-8426174,2022-07-06,2022-07-06,Groceries
40906174,365587,0,-8791761,2022-07-06,2022-07-06,Education
40906174,344491,0,-9136252,2022-07-06,2022-07-06,Transportation
40906174,449524,0,-9585776,2022-07-07,2022-07-07,Clothes
40906174,369381,0,-9955157,2022-07-07,2022-07-07,Healthcare
40906174,0,11599,-9943558,2022-07-08,2022-07-08,
40906174,0,335146,-9608412,2022-07-08,2022-07-08,
40906174,465092,0,-9623062,2022-07-09,2022-07-09,Education
40906174,18778,0,-9641840,2022-07-09,2022-07-09,Healthcare
40906174,410110,0,-10051950,2022-07-09,2022-07-09,Healthcare
40906174,14003,0,-10065953,2022-07-10,2022-07-10,Groceries
40906174,13090,0,-10079043,2022-07-10,2022-07-10,Clothes
40906174,0,372633,-9706410,2022-07-11,2022-07-11,
40906174,12206,0,-9718616,2022-07-12,2022-07-12,Education
40906174,445762,0,-10164378,2022-07-12,2022-07-12,Groceries
40906174,0,337160,-9827218,2022-07-12,2022-07-12,
40906174,360713,0,-10187931,2022-07-13,2022-07-13,Groceries
40906174,347937,0,-10535868,2022-07-14,2022-07-14,Clothes
40906174,12912,0,-10548780,2022-07-14,2022-07-14,Transportation
40906174,0,443993,-10104787,2022-07-15,2022-07-15,
40906174,0,411974,-9692813,2022-07-15,2022-07-15,
40906174,0,17280,-9675533,2022-07-15,2022-07-15,
40906174,16389,0,-9691922,2022-07-16,2022-07-16,Healthcare
40906174,0,377291,-9314631,2022-07-17,2022-07-17,
40906174,0,321249,-8993382,2022-07-17,2022-07-17,
40906174,0,351525,-8641857,2022-07-18,2022-07-18,
40906174,11208,0,-8653065,2022-07-18,2022-07-18,Entertainment
40906174,11618,0,-8664683,2022-07-18,2022-07-18,Rent
40906174,0,302851,-8361832,2022-07-19,2022-07-19,
40906174,328890,0,-8690722,2022-07-20,2022-07-20,Clothes
40906174,488727,0,-9179449,2022-07-20,2022-07-20,Transportation
40906174,0,381608,-8797841,2022-07-21,2022-07-21,
40906174,17224,0,-8815065,2022-07-21,2022-07-21,Healthcare
40906174,10307,0,-8825372,2022-07-22,2022-07-22,Utilities
40906174,0,13116,-8812256,2022-07-22,2022-07-22,
40906174,303812,0,-9116068,2022-07-22,2022-07-22,Rent
40906174,499027,0,-9615095,2022-07-23,2022-07-23,Clothes
40906174,0,365144,-9249951,2022-07-24,2022-07-24,
40906174,477419,0,-9727370,2022-07-24,2022-07-24,Transportation
40906174,469256,0,-10196626,2022-07-25,2022-07-25,Bill Sharing
40906174,585963,0,-9712495,2022-07-25,2022-07-25,Education
40906174,0,428646,-9283849,2022-07-26,2022-07-26,
40906174,333649,0,-9617498,2022-07-26,2022-07-26,Entertainment
40906174,18950,0,-9636448,2022-07-27,2022-07-27,Transportation
40906174,0,11793,-9624655,2022-07-27,2022-07-27,
40906174,316909,0,-9941564,2022-07-27,2022-07-27,Transportation
40906174,18079,0,-9959643,2022-07-28,2022-07-28,Transportation
40906174,0,441666,-9517977,2022-07-28,2022-07-28,
40906174,17276,0,-9535253,2022-07-29,2022-07-29,Transportation
40906174,354090,0,-9889343,2022-07-30,2022-07-30,Transportation
40906174,0,14156,-9875187,2022-07-30,2022-07-30,
40906174,0,495533,-9379654,2022-07-31,2022-07-31,
40906174,0,483203,-8975055,2022-07-31,2022-07-31,
40906174,0,14357,-8960698,2022-08-01,2022-08-01,
40906174,366576,0,-9327274,2022-08-01,2022-08-01,Education
40906174,0,485414,-8841860,2022-08-02,2022-08-02,
40906174,0,353530,-8488330,2022-08-02,2022-08-02,
40906174,0,14741,-8473589,2022-08-02,2022-08-02,
40906174,0,457618,-8015971,2022-08-03,2022-08-03,
40906174,0,362236,-7653735,2022-08-04,2022-08-04,
40906174,14574,0,-7668309,2022-08-05,2022-08-05,Clothes
40906174,0,301437,-7366872,2022-08-06,2022-08-06,
40906174,364352,0,-7731224,2022-08-07,2022-08-07,Transportation
40906174,379612,0,-8110836,2022-08-07,2022-08-07,Healthcare
40906174,337959,0,-8448795,2022-08-07,2022-08-07,Clothes
40906174,12315,0,-8461110,2022-08-08,2022-08-08,Utilities
40906174,378098,0,-8839208,2022-08-08,2022-08-08,Transportation
40906174,0,384406,-8454802,2022-08-08,2022-08-08,
40906174,0,342470,-8112332,2022-08-09,2022-08-09,
40906174,0,426307,-7686025,2022-08-09,2022-08-09,
40906174,0,480126,-7205899,2022-08-09,2022-08-09,
40906174,0,19064,-7186835,2022-08-10,2022-08-10,
40906174,0,476485,-6710350,2022-08-11,2022-08-11,
40906174,344172,0,-7054522,2022-08-12,2022-08-12,Transportation
40906174,0,16728,-7037794,2022-08-12,2022-08-12,
40906174,0,13295,-7024499,2022-08-12,2022-08-12,
40906174,14118,0,-7038617,2022-08-13,2022-08-13,Clothes
40906174,521896,0,-6675952,2022-08-13,2022-08-13,Healthcare
40906174,345309,0,-7021261,2022-08-14,2022-08-14,Education
40906174,497169,0,-7518430,2022-08-14,2022-08-14,Rent
40906174,10713,0,-7529143,2022-08-15,2022-08-15,Groceries
40906174,323108,0,-7852251,2022-08-16,2022-08-16,Education
40906174,0,324393,-7527858,2022-08-16,2022-08-16,
40906174,0,10087,-7517771,2022-08-16,2022-08-16,
40906174,0,307923,-7209848,2022-08-17,2022-08-17,
40906174,403802,0,-7613650,2022-08-17,2022-08-17,Groceries
40906174,318346,0,-7931996,2022-08-18,2022-08-18,Rent
40906174,0,459875,-7472121,2022-08-19,2022-08-19,
40906174,12315,0,-7484436,2022-08-19,2022-08-19,Healthcare
40906174,0,321288,-7163148,2022-08-19,2022-08-19,
40906174,10882,0,-7174030,2022-08-20,2022-08-20,Transportation
40906174,0,16886,-7157144,2022-08-20,2022-08-20,
40906174,0,14570,-7142574,2022-08-21,2022-08-21,
40906174,0,16732,-7125842,2022-08-21,2022-08-21,
40906174,0,319065,-6806777,2022-08-21,2022-08-21,
40906174,17763,0,-6824540,2022-08-22,2022-08-22,Groceries
40906174,323978,0,-7148518,2022-08-22,2022-08-22,Clothes
40906174,418687,0,-7567205,2022-08-22,2022-08-22,Bill Sharing
40906174,419386,0,-7986591,2022-08-23,2022-08-23,Rent
40906174,0,10435,-7976156,2022-08-24,2022-08-24,
40906174,313410,0,-8289566,2022-08-24,2022-08-24,Entertainment
40906174,11882,0,-8301448,2022-08-24,2022-08-24,Transportation
40906174,439716,0,-8741164,2022-08-25,2022-08-25,Entertainment
40906174,0,10373,-8730791,2022-08-25,2022-08-25,
40906174,0,442929,-8287862,2022-08-26,2022-08-26,
40906174,0,303045,-7984817,2022-08-26,2022-08-26,
40906174,0,306378,-7678439,2022-08-26,2022-08-26,
40906174,0,493985,-7184454,2022-08-27,2022-08-27,
40906174,0,471161,-6713293,2022-08-27,2022-08-27,
40906174,0,14820,-6698473,2022-08-27,2022-08-27,
40906174,17458,0,-6715931,2022-08-28,2022-08-28,Education
40906174,10716,0,-6726647,2022-08-29,2022-08-29,Utilities
40906174,17086,0,-6743733,2022-08-29,2022-08-29,Groceries
40906174,408519,0,-7152252,2022-08-29,2022-08-29,Clothes
40906174,0,14138,-7138114,2022-08-30,2022-08-30,
40906174,352117,0,-7490231,2022-08-31,2022-08-31,Utilities
40906174,402129,0,-7892360,2022-08-31,2022-08-31,Utilities
40906174,0,404767,-7487593,2022-08-31,2022-08-31,
40906174,0,465491,-7022102,2022-09-01,2022-09-01,
40906174,0,13792,-7008310,2022-09-01,2022-09-01,
40906174,10792,0,-7019102,2022-09-01,2022-09-01,Education
40906174,0,326392,-6692710,2022-09-02,2022-09-02,
40906174,0,16492,-6676218,2022-09-02,2022-09-02,
40906174,0,14253,-6661965,2022-09-02,2022-09-02,
40906174,12678,0,-6674643,2022-09-03,2022-09-03,Bill Sharing
40906174,0,329125,-6345518,2022-09-03,2022-09-03,
40906174,0,338704,-6006814,2022-09-04,2022-09-04,
40906174,0,357665,-5649149,2022-09-04,2022-09-04,
40906174,0,497675,-5151474,2022-09-05,2022-09-05,
40906174,369632,0,-5521106,2022-09-05,2022-09-05,Entertainment
40906174,0,344668,-5176438,2022-09-05,2022-09-05,
40906174,0,412705,-4763733,2022-09-06,2022-09-06,
40906174,0,345916,-4417817,2022-09-07,2022-09-07,
40906174,0,339276,-4078541,2022-09-07,2022-09-07,
40906174,0,365863,-3712678,2022-09-08,2022-09-08,
40906174,18714,0,-3731392,2022-09-08,2022-09-08,Clothes
40906174,407921,0,-4139313,2022-09-08,2022-09-08,Utilities
40906174,0,348757,-3790556,2022-09-09,2022-09-09,
40906174,333669,0,-4124225,2022-09-09,2022-09-09,Rent
40906174,0,15677,-4108548,2022-09-10,2022-09-10,
40906174,0,12591,-4095957,2022-09-10,2022-09-10,
40906174,13022,0,-4108979,2022-09-11,2022-09-11,Groceries
40906174,0,13720,-4095259,2022-09-12,2022-09-12,
40906174,14329,0,-4109588,2022-09-13,2022-09-13,Utilities
40906174,10208,0,-4119796,2022-09-13,2022-09-13,Rent
40906174,11370,0,-4131166,2022-09-13,2022-09-13,Bill Sharing
40906174,19294,0,-4150460,2022-09-14,2022-09-14,Clothes
40906174,17785,0,-4168245,2022-09-15,2022-09-15,Groceries
40906174,0,414474,-3753771,2022-09-15,2022-09-15,
40906174,0,16702,-3737069,2022-09-15,2022-09-15,
40906174,11778,0,-3748847,2022-09-16,2022-09-16,Transportation
40906174,0,347390,-3401457,2022-09-16,2022-09-16,
40906174,0,470278,-2931179,2022-09-16,2022-09-16,
40906174,352467,0,-3283646,2022-09-17,2022-09-17,Groceries
40906174,422096,0,-3705742,2022-09-17,2022-09-17,Groceries
40906174,0,17240,-3688502,2022-09-18,2022-09-18,
40906174,12247,0,-3700749,2022-09-18,2022-09-18,Groceries
40906174,345762,0,-4046511,2022-09-18,2022-09-18,Rent
40906174,0,15581,-4030930,2022-09-19,2022-09-19,
40906174,361541,0,-4392471,2022-09-20,2022-09-20,Rent
40906174,544607,0,-4736319,2022-09-20,2022-09-20,Healthcare
40906174,0,399059,-4337260,2022-09-21,2022-09-21,
40906174,323275,0,-4660535,2022-09-21,2022-09-21,Entertainment
40906174,490375,0,-4301971,2022-09-22,2022-09-22,Healthcare
40906174,0,398186,-3903785,2022-09-22,2022-09-22,
40906174,17147,0,-3920932,2022-09-23,2022-09-23,Education
40906174,320665,0,-4241597,2022-09-23,2022-09-23,Clothes
40906174,0,395031,-3846566,2022-09-23,2022-09-23,
40906174,0,430363,-3416203,2022-09-24,2022-09-24,
40906174,11315,0,-3427518,2022-09-25,2022-09-25,Education
40906174,0,19501,-3408017,2022-09-26,2022-09-26,
40906174,0,307327,-3100690,2022-09-26,2022-09-26,
40906174,0,431016,-2669674,2022-09-27,2022-09-27,
40906174,11074,0,-2680748,2022-09-28,2022-09-28,Entertainment
40906174,337561,0,-3018309,2022-09-29,2022-09-29,Rent
40906174,18375,0,-3036684,2022-09-29,2022-09-29,Clothes
40906174,384945,0,-3421629,2022-09-29,2022-09-29,Rent
40906174,0,432050,-2989579,2022-09-30,2022-09-30,
40906174,0,496791,-2492788,2022-10-01,2022-10-01,
40906174,0,14096,-2478692,2022-10-01,2022-10-01,
40906174,485220,0,-2963912,2022-10-01,2022-10-01,Entertainment
40906174,0,317414,-2646498,2022-10-02,2022-10-02,
40906174,367950,0,-3014448,2022-10-02,2022-10-02,Education
40906174,987694,0,-2680292,2022-10-02,2022-10-02,Healthcare
40906174,12556,0,-2692848,2022-10-03,2022-10-03,Bill Sharing
40906174,387457,0,-3080305,2022-10-03,2022-10-03,Utilities
40906174,19704,0,-3100009,2022-10-04,2022-10-04,Bill Sharing
40906174,453618,0,-3553627,2022-10-05,2022-10-05,Rent
40906174,0,448495,-3105132,2022-10-06,2022-10-06,
40906174,0,457061,-2648071,2022-10-06,2022-10-06,
40906174,0,15653,-2632418,2022-10-07,2022-10-07,
40906174,0,301253,-2331165,2022-10-07,2022-10-07,
40906174,0,16096,-2315069,2022-10-07,2022-10-07,
40906174,0,11577,-2303492,2022-10-08,2022-10-08,
40906174,0,461994,-1841498,2022-10-09,2022-10-09,
40906174,0,18941,-1822557,2022-10-09,2022-10-09,
40906174,382095,0,-2204652,2022-10-10,2022-10-10,Education
40906174,0,309300,-1895352,2022-10-10,2022-10-10,
40906174,14452,0,-1909804,2022-10-10,2022-10-10,Healthcare
40906174,18763,0,-1928567,2022-10-11,2022-10-11,Groceries
40906174,464854,0,-2393421,2022-10-11,2022-10-11,Healthcare
40906174,0,418664,-1974757,2022-10-12,2022-10-12,
40906174,0,18862,-1955895,2022-10-12,2022-10-12,
40906174,0,488601,-1467294,2022-10-12,2022-10-12,
40906174,0,389274,-1078020,2022-10-13,2022-10-13,
40906174,401142,0,-1479162,2022-10-13,2022-10-13,Entertainment
40906174,0,315583,-1163579,2022-10-14,2022-10-14,
40906174,0,486236,-677343,2022-10-15,2022-10-15,
40906174,0,313883,-363460,2022-10-15,2022-10-15,
40906174,0,19940,-343520,2022-10-15,2022-10-15,
40906174,11734,0,-355254,2022-10-16,2022-10-16,Transportation
40906174,308985,0,-664239,2022-10-16,2022-10-16,Entertainment
40906174,0,368418,-295821,2022-10-17,2022-10-17,
40906174,0,439016,143195,2022-10-18,2022-10-18,
40906174,18361,0,124834,2022-10-18,2022-10-18,Clothes
40906174,0,301832,426666,2022-10-19,2022-10-19,
40906174,482511,0,-55845,2022-10-20,2022-10-20,Bill Sharing
40906174,354161,0,-410006,2022-10-20,2022-10-20,Entertainment
40906174,368673,0,-778679,2022-10-20,2022-10-20,Utilities
40906174,0,17157,-761522,2022-10-21,2022-10-21,
40906174,0,18197,-743325,2022-10-21,2022-10-21,
40906174,303910,0,-1047235,2022-10-21,2022-10-21,Entertainment
40906174,19866,0,-1067101,2022-10-22,2022-10-22,Healthcare
40906174,0,435990,-631111,2022-10-23,2022-10-23,
40906174,0,15838,-615273,2022-10-23,2022-10-23,
40906174,445887,0,-1061160,2022-10-23,2022-10-23,Clothes
40906174,315041,0,-1376201,2022-10-24,2022-10-24,Clothes
40906174,445813,0,-1822014,2022-10-24,2022-10-24,Entertainment
40906174,0,16401,-1805613,2022-10-24,2022-10-24,
40906174,11433,0,-1817046,2022-10-25,2022-10-25,Education
40906174,0,446062,-1370984,2022-10-26,2022-10-26,
40906174,0,14786,-1356198,2022-10-26,2022-10-26,
40906174,372664,0,-1728862,2022-10-27,2022-10-27,Clothes
40906174,0,306946,-1421916,2022-10-28,2022-10-28,
40906174,0,12657,-1409259,2022-10-28,2022-10-28,
40906174,324516,0,-1733775,2022-10-29,2022-10-29,Transportation
40906174,0,19542,-1714233,2022-10-29,2022-10-29,
40906174,12359,0,-1726592,2022-10-30,2022-10-30,Groceries
40906174,0,12761,-1713831,2022-10-30,2022-10-30,
40906174,17980,0,-1731811,2022-10-31,2022-10-31,Entertainment
40906174,17135,0,-1748946,2022-11-01,2022-11-01,Rent
40906174,450141,0,-2199087,2022-11-01,2022-11-01,Bill Sharing
40906174,483726,0,-2682813,2022-11-01,2022-11-01,Rent
40906174,14543,0,-2697356,2022-11-02,2022-11-02,Bill Sharing
40906174,0,343213,-2354143,2022-11-02,2022-11-02,
40906174,0,16712,-2337431,2022-11-03,2022-11-03,
40906174,15568,0,-2352999,2022-11-03,2022-11-03,Entertainment
40906174,0,12439,-2340560,2022-11-04,2022-11-04,
40906174,0,674000,-2692732,2022-11-05,2022-11-05,
40906174,449509,0,-3142241,2022-11-05,2022-11-05,Utilities
40906174,0,426743,-2715498,2022-11-05,2022-11-05,
40906174,0,368358,-2347140,2022-11-06,2022-11-06,
40906174,0,351319,-1995821,2022-11-07,2022-11-07,
40906174,0,326734,-1669087,2022-11-07,2022-11-07,
40906174,485468,0,-2154555,2022-11-07,2022-11-07,Bill Sharing
40906174,0,10768,-2143787,2022-11-08,2022-11-08,
40906174,0,16105,-2127682,2022-11-08,2022-11-08,
40906174,319022,0,-2446704,2022-11-09,2022-11-09,Healthcare
40906174,807706,0,-2431650,2022-11-09,2022-11-09,Education
40906174,470647,0,-2902297,2022-11-10,2022-11-10,Education
40906174,0,18923,-2883374,2022-11-10,2022-11-10,
40906174,0,375413,-2507961,2022-11-10,2022-11-10,
40906174,354311,0,-2862272,2022-11-11,2022-11-11,Education
40906174,13016,0,-2875288,2022-11-11,2022-11-11,Utilities
40906174,14650,0,-2889938,2022-11-12,2022-11-12,Utilities
40906174,347544,0,-3237482,2022-11-13,2022-11-13,Transportation
40906174,0,443438,-2794044,2022-11-13,2022-11-13,
40906174,12403,0,-2806447,2022-11-14,2022-11-14,Transportation
40906174,0,470872,-2335575,2022-11-14,2022-11-14,
40906174,0,450956,-1884619,2022-11-14,2022-11-14,
40906174,485256,0,-2369875,2022-11-15,2022-11-15,Clothes
40906174,0,19388,-2350487,2022-11-15,2022-11-15,
40906174,0,360168,-1990319,2022-11-15,2022-11-15,
40906174,0,442151,-1548168,2022-11-16,2022-11-16,
40906174,0,328603,-1219565,2022-11-16,2022-11-16,
40906174,14814,0,-1234379,2022-11-16,2022-11-16,Clothes
40906174,469129,0,-1703508,2022-11-17,2022-11-17,Groceries
40906174,0,12201,-1691307,2022-11-18,2022-11-18,
40906174,332221,0,-2023528,2022-11-18,2022-11-18,Clothes
40906174,486431,0,-2509959,2022-11-19,2022-11-19,Clothes
40906174,0,353918,-2156041,2022-11-20,2022-11-20,
40906174,15612,0,-2171653,2022-11-20,2022-11-20,Bill Sharing
40906174,0,11778,-2159875,2022-11-21,2022-11-21,
40906174,0,439769,-1720106,2022-11-21,2022-11-21,
40906174,18253,0,-1738359,2022-11-21,2022-11-21,Bill Sharing
40906174,11627,0,-1749986,2022-11-22,2022-11-22,Rent
40906174,0,407470,-1342516,2022-11-23,2022-11-23,
40906174,458425,0,-1800941,2022-11-23,2022-11-23,Groceries
40906174,0,18939,-1782002,2022-11-23,2022-11-23,
40906174,0,10435,-1771567,2022-11-24,2022-11-24,
40906174,0,16748,-1754819,2022-11-24,2022-11-24,
40906174,485952,0,-2240771,2022-11-24,2022-11-24,Healthcare
40906174,0,324109,-1916662,2022-11-25,2022-11-25,
40906174,17573,0,-1934235,2022-11-26,2022-11-26,Utilities
40906174,19733,0,10000,2022-11-27,2022-11-27,Bill Sharing
40906174,11942,0,10000,2022-11-27,2022-11-27,Education
40906174,0,15171,25171,2022-11-27,2022-11-27,
40906174,0,487133,512304,2022-11-28,2022-11-28,
40906174,0,375406,887710,2022-11-28,2022-11-28,
40906174,19172,0,868538,2022-11-28,2022-11-28,Entertainment
40906174,0,15339,883877,2022-11-29,2022-11-29,
40906174,12564,0,871313,2022-11-29,2022-11-29,Bill Sharing
40906174,16124,0,855189,2022-11-30,2022-11-30,Bill Sharing
40906174,0,339299,1194488,2022-11-30,2022-11-30,
40906174,0,18298,1212786,2022-12-01,2022-12-01,
40906174,0,18565,1231351,2022-12-01,2022-12-01,
40906174,864247,0,1722417,2022-12-02,2022-12-02,Healthcare
40906174,361221,0,1361196,2022-12-03,2022-12-03,Clothes
40906174,360303,0,1000893,2022-12-03,2022-12-03,Healthcare
40906174,361234,0,639659,2022-12-04,2022-12-04,Healthcare
40906174,0,12108,651767,2022-12-04,2022-12-04,
40906174,0,426942,1078709,2022-12-05,2022-12-05,
40906174,14770,0,1063939,2022-12-06,2022-12-06,Rent
40906174,456389,0,607550,2022-12-06,2022-12-06,Utilities
40906174,0,11285,618835,2022-12-07,2022-12-07,
40906174,17707,0,601128,2022-12-08,2022-12-08,Healthcare
40906174,0,17387,618515,2022-12-09,2022-12-09,
40906174,0,421468,1039983,2022-12-09,2022-12-09,
40906174,0,396737,1436720,2022-12-10,2022-12-10,
40906174,346522,0,1090198,2022-12-10,2022-12-10,Rent
40906174,404378,0,685820,2022-12-10,2022-12-10,Groceries
40906174,11850,0,673970,2022-12-11,2022-12-11,Groceries
40906174,0,387631,1061601,2022-12-12,2022-12-12,
40906174,346161,0,715440,2022-12-12,2022-12-12,Rent
40906174,0,19437,734877,2022-12-12,2022-12-12,
40906174,312012,0,422865,2022-12-13,2022-12-13,Rent
40906174,11711,0,411154,2022-12-13,2022-12-13,Bill Sharing
40906174,0,414979,826133,2022-12-14,2022-12-14,
40906174,0,11157,837290,2022-12-15,2022-12-15,
40906174,0,12578,849868,2022-12-15,2022-12-15,
40906174,0,437677,1287545,2022-12-15,2022-12-15,
40906174,0,409917,1697462,2022-12-16,2022-12-16,
40906174,364633,0,1332829,2022-12-16,2022-12-16,Education
40906174,316834,0,1015995,2022-12-16,2022-12-16,Bill Sharing
40906174,497646,0,518349,2022-12-17,2022-12-17,Education
40906174,0,352431,870780,2022-12-17,2022-12-17,
40906174,0,485838,1356618,2022-12-17,2022-12-17,
40906174,0,337091,1693709,2022-12-18,2022-12-18,
40906174,0,397447,2091156,2022-12-18,2022-12-18,
40906174,388765,0,1702391,2022-12-19,2022-12-19,Bill Sharing
40906174,0,17558,1719949,2022-12-20,2022-12-20,
40906174,0,15915,1735864,2022-12-20,2022-12-20,
40906174,424828,0,1311036,2022-12-20,2022-12-20,Transportation
40906174,479702,0,831334,2022-12-21,2022-12-21,Utilities
40906174,442237,0,389097,2022-12-22,2022-12-22,Utilities
40906174,19761,0,369336,2022-12-22,2022-12-22,Rent
40906174,0,12957,382293,2022-12-23,2022-12-23,
40906174,14201,0,368092,2022-12-23,2022-12-23,Utilities
40906174,0,10580,378672,2022-12-23,2022-12-23,
40906174,10863,0,367809,2022-12-24,2022-12-24,Utilities
40906174,429420,0,10000,2022-12-24,2022-12-24,Bill Sharing
40906174,0,397644,407644,2022-12-24,2022-12-24,
40906174,445268,0,10000,2022-12-25,2022-12-25,Clothes
40906174,0,368342,378342,2022-12-25,2022-12-25,
40906174,460192,0,10000,2022-12-26,2022-12-26,Groceries
40906174,414384,0,10000,2022-12-26,2022-12-26,Entertainment
40906174,0,11141,21141,2022-12-27,2022-12-27,
40906174,0,466853,487994,2022-12-28,2022-12-28,
40906174,0,491501,979495,2022-12-28,2022-12-28,
40906174,0,338240,1317735,2022-12-28,2022-12-28,
40906174,15008,0,1302727,2022-12-29,2022-12-29,Education
40906174,0,398741,1701468,2022-12-30,2022-12-30,
40906174,0,18760,1720228,2022-12-30,2022-12-30,
40906174,0,379554,2099782,2022-12-31,2022-12-31,
40906174,13610,0,2086172,2023-01-01,2023-01-01,Education
40906174,0,13410,2099582,2023-01-01,2023-01-01,
40906174,10665,0,2088917,2023-01-02,2023-01-02,Entertainment
40906174,18722,0,2070195,2023-01-02,2023-01-02,Bill Sharing
40906174,0,19049,2089244,2023-01-03,2023-01-03,
40906174,452966,0,1636278,2023-01-04,2023-01-04,Clothes
40906174,0,10399,1646677,2023-01-04,2023-01-04,
40906174,0,389817,2036494,2023-01-05,2023-01-05,
40906174,17633,0,2018861,2023-01-05,2023-01-05,Entertainment
40906174,0,14574,2033435,2023-01-06,2023-01-06,
40906174,0,12195,2045630,2023-01-06,2023-01-06,
40906174,394978,0,1650652,2023-01-07,2023-01-07,Clothes
40906174,0,17901,1668553,2023-01-07,2023-01-07,
40906174,0,19885,1688438,2023-01-07,2023-01-07,
40906174,477587,0,1210851,2023-01-08,2023-01-08,Education
40906174,0,401321,1612172,2023-01-09,2023-01-09,
40906174,12633,0,1599539,2023-01-09,2023-01-09,Healthcare
40906174,0,470601,2070140,2023-01-10,2023-01-10,
40906174,0,411059,2481199,2023-01-10,2023-01-10,
40906174,0,461842,2943041,2023-01-10,2023-01-10,
40906174,423829,0,2519212,2023-01-11,2023-01-11,Groceries
40906174,313660,0,2205552,2023-01-11,2023-01-11,Groceries
40906174,389493,0,1816059,2023-01-11,2023-01-11,Transportation
40906174,12577,0,1803482,2023-01-12,2023-01-12,Bill Sharing
40906174,0,413385,2216867,2023-01-13,2023-01-13,
40906174,16503,0,2200364,2023-01-13,2023-01-13,Healthcare
40906174,0,11068,2211432,2023-01-14,2023-01-14,
40906174,12948,0,2198484,2023-01-15,2023-01-15,Bill Sharing
40906174,628269,0,1720755,2023-01-16,2023-01-16,Education
40906174,384837,0,1335918,2023-01-17,2023-01-17,Transportation
40906174,319450,0,1016468,2023-01-18,2023-01-18,Utilities
40906174,0,18059,1034527,2023-01-18,2023-01-18,
40906174,356293,0,678234,2023-01-18,2023-01-18,Utilities
40906174,0,17842,696076,2023-01-19,2023-01-19,
40906174,0,394827,1090903,2023-01-19,2023-01-19,
40906174,499970,0,590933,2023-01-19,2023-01-19,Utilities
40906174,0,17780,608713,2023-01-20,2023-01-20,
40906174,11258,0,597455,2023-01-20,2023-01-20,Utilities
40906174,0,438819,1036274,2023-01-21,2023-01-21,
40906174,371035,0,665239,2023-01-21,2023-01-21,Groceries
40906174,0,499182,1164421,2023-01-21,2023-01-21,
40906174,0,329465,1493886,2023-01-22,2023-01-22,
40906174,0,346275,1840161,2023-01-22,2023-01-22,
40906174,0,450864,2291025,2023-01-22,2023-01-22,
40906174,380947,0,1910078,2023-01-23,2023-01-23,Rent
40906174,368384,0,1541694,2023-01-23,2023-01-23,Bill Sharing
40906174,355138,0,1186556,2023-01-24,2023-01-24,Groceries
40906174,12690,0,1173866,2023-01-24,2023-01-24,Bill Sharing
40906174,422005,0,751861,2023-01-25,2023-01-25,Bill Sharing
40906174,14812,0,737049,2023-01-26,2023-01-26,Entertainment
40906174,470693,0,266356,2023-01-26,2023-01-26,Transportation
40906174,374841,0,10000,2023-01-27,2023-01-27,Entertainment
40906174,388906,0,10000,2023-01-27,2023-01-27,Utilities
40906174,15257,0,10000,2023-01-27,2023-01-27,Education
40906174,0,460219,470219,2023-01-28,2023-01-28,
40906174,0,488824,959043,2023-01-28,2023-01-28,
40906174,0,10060,969103,2023-01-28,2023-01-28,
40906174,0,340031,1309134,2023-01-29,2023-01-29,
40906174,17616,0,1291518,2023-01-29,2023-01-29,Rent
40906174,0,16387,1307905,2023-01-30,2023-01-30,
40906174,427450,0,880455,2023-01-30,2023-01-30,Entertainment
40906174,0,353604,1234059,2023-01-31,2023-01-31,
40906174,16623,0,1217436,2023-01-31,2023-01-31,Education
40906174,0,19791,1237227,2023-01-31,2023-01-31,
40906174,0,350902,1588129,2023-02-01,2023-02-01,
40906174,384518,0,1203611,2023-02-01,2023-02-01,Utilities
40906174,436110,0,767501,2023-02-01,2023-02-01,Entertainment
40906174,392742,0,374759,2023-02-02,2023-02-02,Healthcare
40906174,0,18974,393733,2023-02-03,2023-02-03,
40906174,347153,0,46580,2023-02-03,2023-02-03,Utilities
40906174,454981,0,10000,2023-02-04,2023-02-04,Education
40906174,432759,0,10000,2023-02-04,2023-02-04,Bill Sharing
40906174,0,410776,420776,2023-02-04,2023-02-04,
40906174,15947,0,404829,2023-02-05,2023-02-05,Healthcare
40906174,468927,0,10000,2023-02-05,2023-02-05,Rent
40906174,0,394443,404443,2023-02-05,2023-02-05,
40906174,0,433582,838025,2023-02-06,2023-02-06,
40906174,0,482082,1320107,2023-02-06,2023-02-06,
40906174,0,461273,1781380,2023-02-06,2023-02-06,
40906174,496014,0,1285366,2023-02-07,2023-02-07,Utilities
40906174,0,486622,1771988,2023-02-07,2023-02-07,
40906174,19519,0,1752469,2023-02-07,2023-02-07,Clothes
40906174,0,969326,1332965,2023-02-08,2023-02-08,
40906174,473756,0,859209,2023-02-08,2023-02-08,Utilities
40906174,0,18929,878138,2023-02-09,2023-02-09,
40906174,0,364245,1242383,2023-02-10,2023-02-10,
40906174,17410,0,1224973,2023-02-10,2023-02-10,Bill Sharing
40906174,0,401358,1626331,2023-02-10,2023-02-10,
40906174,0,427731,2054062,2023-02-11,2023-02-11,
40906174,0,470278,2524340,2023-02-11,2023-02-11,
40906174,494552,0,2029788,2023-02-11,2023-02-11,Clothes
40906174,18307,0,2011481,2023-02-12,2023-02-12,Healthcare
40906174,10928,0,2000553,2023-02-12,2023-02-12,Education
40906174,0,327016,2327569,2023-02-13,2023-02-13,
40906174,450409,0,1877160,2023-02-14,2023-02-14,Transportation
40906174,0,410300,2287460,2023-02-15,2023-02-15,
40906174,0,17595,2305055,2023-02-15,2023-02-15,
40906174,0,15435,2320490,2023-02-15,2023-02-15,
40906174,468456,0,1852034,2023-02-16,2023-02-16,Healthcare
40906174,361880,0,1490154,2023-02-16,2023-02-16,Transportation
40906174,10291,0,1479863,2023-02-16,2023-02-16,Rent
40906174,0,10484,1490347,2023-02-17,2023-02-17,
40906174,424200,0,1066147,2023-02-17,2023-02-17,Groceries
40906174,0,499156,1565303,2023-02-17,2023-02-17,
40906174,18866,0,1546437,2023-02-18,2023-02-18,Utilities
40906174,455944,0,1090493,2023-02-18,2023-02-18,Transportation
40906174,0,453197,1543690,2023-02-18,2023-02-18,
40906174,15578,0,1528112,2023-02-19,2023-02-19,Transportation
40906174,0,385571,1913683,2023-02-19,2023-02-19,
40906174,0,433965,2347648,2023-02-19,2023-02-19,
40906174,19514,0,2328134,2023-02-20,2023-02-20,Utilities
40906174,325324,0,2002810,2023-02-20,2023-02-20,Rent
40906174,322191,0,1680619,2023-02-20,2023-02-20,Utilities
40906174,0,367701,2048320,2023-02-21,2023-02-21,
40906174,306052,0,1742268,2023-02-21,2023-02-21,Rent
40906174,0,13050,1755318,2023-02-22,2023-02-22,
40906174,12974,0,1742344,2023-02-23,2023-02-23,Utilities
40906174,11631,0,1730713,2023-02-23,2023-02-23,Transportation
40906174,0,10346,1741059,2023-02-24,2023-02-24,
40906174,19975,0,1721084,2023-02-24,2023-02-24,Bill Sharing
40906174,0,17559,1738643,2023-02-25,2023-02-25,
40906174,12121,0,1726522,2023-02-26,2023-02-26,Entertainment
40906174,657640,0,1364563,2023-02-26,2023-02-26,Healthcare
40906174,13600,0,1350963,2023-02-26,2023-02-26,Transportation
40906174,0,493024,1843987,2023-02-27,2023-02-27,
40906174,446059,0,1397928,2023-02-27,2023-02-27,Entertainment
40906174,0,18813,1416741,2023-02-27,2023-02-27,
40906174,0,17791,1434532,2023-02-28,2023-02-28,
40906174,0,10990,1445522,2023-02-28,2023-02-28,
40906174,14204,0,1431318,2023-03-01,2023-03-01,Education
40906174,0,12588,1443906,2023-03-01,2023-03-01,
40906174,0,334657,1778563,2023-03-01,2023-03-01,
40906174,0,310217,2088780,2023-03-02,2023-03-02,
40906174,383334,0,1705446,2023-03-03,2023-03-03,Entertainment
40906174,18340,0,1687106,2023-03-04,2023-03-04,Healthcare
40906174,0,388994,2076100,2023-03-04,2023-03-04,
40906174,18589,0,2057511,2023-03-05,2023-03-05,Transportation
40906174,0,11499,2069010,2023-03-05,2023-03-05,
40906174,0,15228,2084238,2023-03-05,2023-03-05,
40906174,0,420651,2504889,2023-03-06,2023-03-06,
40906174,0,17178,2522067,2023-03-07,2023-03-07,
40906174,310783,0,2211284,2023-03-08,2023-03-08,Utilities
40906174,0,364240,2575524,2023-03-08,2023-03-08,
40906174,0,367710,2943234,2023-03-09,2023-03-09,
40906174,0,395484,3338718,2023-03-09,2023-03-09,
40906174,0,17242,3355960,2023-03-09,2023-03-09,
40906174,0,14775,3370735,2023-03-10,2023-03-10,
40906174,0,18752,3389487,2023-03-10,2023-03-10,
40906174,0,319364,3708851,2023-03-10,2023-03-10,
40906174,0,15817,3724668,2023-03-11,2023-03-11,
40906174,0,410796,4135464,2023-03-11,2023-03-11,
40906174,314637,0,3820827,2023-03-11,2023-03-11,Utilities
40906174,0,361695,4182522,2023-03-12,2023-03-12,
40906174,16010,0,4166512,2023-03-12,2023-03-12,Clothes
40906174,382246,0,3784266,2023-03-13,2023-03-13,Bill Sharing
40906174,0,336064,4120330,2023-03-13,2023-03-13,
40906174,363137,0,3757193,2023-03-14,2023-03-14,Utilities
40906174,464624,0,3292569,2023-03-15,2023-03-15,Transportation
40906174,358407,0,2934162,2023-03-16,2023-03-16,Groceries
40906174,0,466126,2916877,2023-03-17,2023-03-17,
40906174,0,411667,3328544,2023-03-17,2023-03-17,
40906174,394305,0,2934239,2023-03-17,2023-03-17,Entertainment
40906174,10941,0,2923298,2023-03-18,2023-03-18,Groceries
40906174,12775,0,2910523,2023-03-18,2023-03-18,Rent
40906174,0,12518,2923041,2023-03-19,2023-03-19,
40906174,0,13135,2936176,2023-03-19,2023-03-19,
40906174,0,340368,3276544,2023-03-19,2023-03-19,
40906174,0,316928,3593472,2023-03-20,2023-03-20,
40906174,0,481465,4074937,2023-03-21,2023-03-21,
40906174,322143,0,3752794,2023-03-22,2023-03-22,Clothes
40906174,413171,0,3339623,2023-03-22,2023-03-22,Healthcare
40906174,485030,0,2854593,2023-03-22,2023-03-22,Education
40906174,337843,0,2516750,2023-03-23,2023-03-23,Rent
40906174,18592,0,2498158,2023-03-24,2023-03-24,Healthcare
40906174,0,381585,2879743,2023-03-24,2023-03-24,
40906174,413710,0,2466033,2023-03-24,2023-03-24,Rent
40906174,481913,0,1984120,2023-03-25,2023-03-25,Education
40906174,0,11519,1995639,2023-03-26,2023-03-26,
40906174,0,17494,2013133,2023-03-26,2023-03-26,
40906174,0,14730,2027863,2023-03-27,2023-03-27,
40906174,0,304009,2331872,2023-03-27,2023-03-27,
40906174,473122,0,1858750,2023-03-27,2023-03-27,Education
40906174,0,490718,2349468,2023-03-28,2023-03-28,
40906174,14917,0,2334551,2023-03-28,2023-03-28,Groceries
40906174,0,430152,2764703,2023-03-28,2023-03-28,
40906174,0,393017,3157720,2023-03-29,2023-03-29,
40906174,0,381568,3539288,2023-03-29,2023-03-29,
40906174,16858,0,3522430,2023-03-29,2023-03-29,Entertainment
40906174,0,496733,4019163,2023-03-30,2023-03-30,
40906174,0,453142,4472305,2023-03-31,2023-03-31,
40906174,0,355694,4827999,2023-03-31,2023-03-31,
40906174,333969,0,4494030,2023-03-31,2023-03-31,Rent
40906174,0,17387,4511417,2023-04-01,2023-04-01,
40906174,14654,0,4496763,2023-04-01,2023-04-01,Groceries
40906174,12618,0,4484145,2023-04-01,2023-04-01,Rent
40906174,19478,0,4464667,2023-04-02,2023-04-02,Clothes
40906174,480652,0,3984015,2023-04-02,2023-04-02,Rent
40906174,730221,0,3538244,2023-04-02,2023-04-02,Education
40906174,347690,0,3190554,2023-04-03,2023-04-03,Rent
40906174,0,13424,3203978,2023-04-03,2023-04-03,
40906174,14726,0,3189252,2023-04-03,2023-04-03,Healthcare
40906174,0,10259,3199511,2023-04-04,2023-04-04,
40906174,0,402672,3602183,2023-04-05,2023-04-05,
40906174,0,16188,3618371,2023-04-05,2023-04-05,
40906174,479592,0,3138779,2023-04-06,2023-04-06,Clothes
40906174,679194,0,2704616,2023-04-07,2023-04-07,Healthcare
40906174,0,421175,3125791,2023-04-07,2023-04-07,
40906174,0,15282,3141073,2023-04-07,2023-04-07,
40906174,499553,0,2641520,2023-04-08,2023-04-08,Healthcare
40906174,18651,0,2622869,2023-04-08,2023-04-08,Clothes
40906174,14497,0,2608372,2023-04-08,2023-04-08,Utilities
40906174,375212,0,2233160,2023-04-09,2023-04-09,Healthcare
40906174,0,461663,2694823,2023-04-09,2023-04-09,
40906174,419524,0,2275299,2023-04-10,2023-04-10,Transportation
40906174,315697,0,1959602,2023-04-10,2023-04-10,Entertainment
40906174,0,405033,2364635,2023-04-11,2023-04-11,
40906174,0,15803,2380438,2023-04-11,2023-04-11,
40906174,0,357236,2737674,2023-04-11,2023-04-11,
40906174,363411,0,2374263,2023-04-12,2023-04-12,Education
40906174,472898,0,1901365,2023-04-12,2023-04-12,Entertainment
40906174,0,12962,1914327,2023-04-13,2023-04-13,
40906174,499570,0,1414757,2023-04-13,2023-04-13,Healthcare
40906174,0,420360,1835117,2023-04-13,2023-04-13,
40906174,416107,0,1419010,2023-04-14,2023-04-14,Bill Sharing
40906174,343372,0,1075638,2023-04-15,2023-04-15,Education
40906174,17759,0,1057879,2023-04-15,2023-04-15,Healthcare
40906174,0,307249,1365128,2023-04-15,2023-04-15,
40906174,347704,0,1017424,2023-04-16,2023-04-16,Groceries
40906174,355370,0,662054,2023-04-16,2023-04-16,Rent
40906174,0,18505,680559,2023-04-16,2023-04-16,
40906174,337298,0,343261,2023-04-17,2023-04-17,Education
40906174,0,338836,682097,2023-04-17,2023-04-17,
40906174,447637,0,234460,2023-04-18,2023-04-18,Entertainment
40906174,0,360223,594683,2023-04-18,2023-04-18,
40906174,0,462852,1057535,2023-04-19,2023-04-19,
40906174,11505,0,1046030,2023-04-19,2023-04-19,Clothes
40906174,429854,0,616176,2023-04-20,2023-04-20,Rent
40906174,381702,0,234474,2023-04-20,2023-04-20,Utilities
40906174,0,15944,250418,2023-04-20,2023-04-20,
40906174,14159,0,236259,2023-04-21,2023-04-21,Utilities
40906174,0,356414,592673,2023-04-21,2023-04-21,
40906174,494233,0,98440,2023-04-21,2023-04-21,Education
40906174,310194,0,10000,2023-04-22,2023-04-22,Transportation
40906174,0,12316,22316,2023-04-22,2023-04-22,
40906174,484247,0,10000,2023-04-22,2023-04-22,Education
40906174,0,433156,443156,2023-04-23,2023-04-23,
40906174,16486,0,426670,2023-04-23,2023-04-23,Groceries
40906174,0,18200,444870,2023-04-24,2023-04-24,
40906174,356848,0,88022,2023-04-24,2023-04-24,Rent
40906174,0,19974,107996,2023-04-25,2023-04-25,
40906174,0,457079,565075,2023-04-25,2023-04-25,
40906174,427792,0,137283,2023-04-26,2023-04-26,Clothes
40906174,18129,0,119154,2023-04-26,2023-04-26,Bill Sharing
40906174,0,483488,602642,2023-04-27,2023-04-27,
40906174,0,493893,1096535,2023-04-28,2023-04-28,
40906174,19496,0,1077039,2023-04-28,2023-04-28,Healthcare
40906174,0,17475,1094514,2023-04-29,2023-04-29,
40906174,383605,0,710909,2023-04-29,2023-04-29,Healthcare
40906174,17906,0,693003,2023-04-29,2023-04-29,Bill Sharing
40906174,340984,0,352019,2023-04-30,2023-04-30,Rent
40906174,0,304637,656656,2023-04-30,2023-04-30,
40906174,424306,0,232350,2023-05-01,2023-05-01,Entertainment
40906174,0,10429,242779,2023-05-01,2023-05-01,
40906174,0,382573,625352,2023-05-02,2023-05-02,
40906174,12636,0,612716,2023-05-02,2023-05-02,Groceries
40906174,321123,0,291593,2023-05-03,2023-05-03,Clothes
40906174,457397,0,10000,2023-05-03,2023-05-03,Groceries
40906174,395988,0,10000,2023-05-04,2023-05-04,Rent
40906174,0,326810,336810,2023-05-04,2023-05-04,
40906174,0,402669,739479,2023-05-04,2023-05-04,
40906174,0,16209,755688,2023-05-05,2023-05-05,
40906174,367536,0,388152,2023-05-05,2023-05-05,Groceries
40906174,0,18006,406158,2023-05-06,2023-05-06,
40906174,486461,0,10000,2023-05-06,2023-05-06,Education
40906174,303296,0,10000,2023-05-06,2023-05-06,Utilities
40906174,0,704761,499250,2023-05-07,2023-05-07,
40906174,0,11054,510304,2023-05-07,2023-05-07,
40906174,391475,0,118829,2023-05-07,2023-05-07,Bill Sharing
40906174,0,404792,523621,2023-05-08,2023-05-08,
40906174,14535,0,509086,2023-05-08,2023-05-08,Healthcare
40906174,0,16433,525519,2023-05-08,2023-05-08,
40906174,13743,0,511776,2023-05-09,2023-05-09,Clothes
40906174,435504,0,76272,2023-05-10,2023-05-10,Utilities
40906174,365970,0,10000,2023-05-11,2023-05-11,Entertainment
40906174,0,17593,27593,2023-05-11,2023-05-11,
40906174,472223,0,10000,2023-05-11,2023-05-11,Rent
40906174,0,315603,325603,2023-05-12,2023-05-12,
40906174,15367,0,310236,2023-05-12,2023-05-12,Rent
40906174,15568,0,294668,2023-05-12,2023-05-12,Healthcare
40906174,316029,0,10000,2023-05-13,2023-05-13,Groceries
40906174,0,10358,20358,2023-05-13,2023-05-13,
40906174,0,10482,30840,2023-05-14,2023-05-14,
40906174,14037,0,16803,2023-05-14,2023-05-14,Clothes
40906174,0,333056,349859,2023-05-15,2023-05-15,
40906174,373866,0,10000,2023-05-15,2023-05-15,Entertainment
40906174,322418,0,10000,2023-05-15,2023-05-15,Bill Sharing
40906174,0,15855,25855,2023-05-16,2023-05-16,
40906174,0,12203,38058,2023-05-16,2023-05-16,
40906174,18123,0,19935,2023-05-16,2023-05-16,Groceries
40906174,353766,0,10000,2023-05-17,2023-05-17,Transportation
40906174,0,18417,28417,2023-05-17,2023-05-17,
40906174,0,447898,476315,2023-05-17,2023-05-17,
40906174,0,401893,878208,2023-05-18,2023-05-18,
40906174,403482,0,474726,2023-05-18,2023-05-18,Healthcare
40906174,0,329981,804707,2023-05-19,2023-05-19,
40906174,483492,0,321215,2023-05-19,2023-05-19,Bill Sharing
40906174,15929,0,305286,2023-05-19,2023-05-19,Utilities
40906174,13499,0,291787,2023-05-20,2023-05-20,Entertainment
40906174,0,465507,757294,2023-05-21,2023-05-21,
40906174,0,336296,1093590,2023-05-21,2023-05-21,
40906174,0,16816,1110406,2023-05-22,2023-05-22,
40906174,392855,0,717551,2023-05-23,2023-05-23,Entertainment
40906174,14585,0,702966,2023-05-23,2023-05-23,Bill Sharing
40906174,0,464486,1167452,2023-05-23,2023-05-23,
40906174,0,19836,1187288,2023-05-24,2023-05-24,
40906174,18454,0,1168834,2023-05-24,2023-05-24,Rent
40906174,0,12482,1181316,2023-05-24,2023-05-24,
40906174,14191,0,1167125,2023-05-25,2023-05-25,Healthcare
40906174,461557,0,705568,2023-05-26,2023-05-26,Transportation
40906174,0,447560,1153128,2023-05-26,2023-05-26,
40906174,16541,0,1136587,2023-05-26,2023-05-26,Entertainment
40906174,324596,0,811991,2023-05-27,2023-05-27,Transportation
40906174,0,483471,1295462,2023-05-28,2023-05-28,
40906174,0,12688,1308150,2023-05-28,2023-05-28,
40906174,0,403591,1711741,2023-05-28,2023-05-28,
40906174,378072,0,1333669,2023-05-29,2023-05-29,Entertainment
40906174,13702,0,1319967,2023-05-29,2023-05-29,Rent
40906174,13019,0,1306948,2023-05-30,2023-05-30,Utilities
40906174,420774,0,886174,2023-05-30,2023-05-30,Groceries
40906174,0,446229,1332403,2023-05-30,2023-05-30,
40906174,455625,0,876778,2023-05-31,2023-05-31,Healthcare
40906174,0,17969,894747,2023-05-31,2023-05-31,
40906174,15834,0,878913,2023-05-31,2023-05-31,Healthcare
40906174,465463,0,413450,2023-06-01,2023-06-01,Healthcare
40906174,19623,0,393827,2023-06-01,2023-06-01,Education
40906174,465816,0,10000,2023-06-01,2023-06-01,Groceries
40906174,0,363388,373388,2023-06-02,2023-06-02,
40906174,0,16266,389654,2023-06-02,2023-06-02,
40906174,0,16083,405737,2023-06-03,2023-06-03,
40906174,0,14712,420449,2023-06-03,2023-06-03,
40906174,420906,0,10000,2023-06-03,2023-06-03,Clothes
40906174,0,380852,390852,2023-06-04,2023-06-04,
40906174,19407,0,371445,2023-06-05,2023-06-05,Transportation
40906174,0,428090,10000,2023-06-06,2023-06-06,
40906174,0,423549,433549,2023-06-07,2023-06-07,
40906174,461591,0,10000,2023-06-08,2023-06-08,Bill Sharing
40906174,307339,0,10000,2023-06-09,2023-06-09,Transportation
40906174,0,419727,429727,2023-06-10,2023-06-10,
40906174,10066,0,419661,2023-06-10,2023-06-10,Entertainment
40906174,0,467915,887576,2023-06-11,2023-06-11,
40906174,19702,0,867874,2023-06-12,2023-06-12,Healthcare
40906174,16002,0,851872,2023-06-13,2023-06-13,Transportation
40906174,0,13103,864975,2023-06-13,2023-06-13,
40906174,0,768840,1272487,2023-06-13,2023-06-13,
40906174,0,17181,1289668,2023-06-14,2023-06-14,
40906174,0,483701,1773369,2023-06-14,2023-06-14,
40906174,421294,0,1352075,2023-06-14,2023-06-14,Groceries
40906174,0,11342,1363417,2023-06-15,2023-06-15,
40906174,394955,0,968462,2023-06-16,2023-06-16,Bill Sharing
40906174,12476,0,955986,2023-06-17,2023-06-17,Clothes
40906174,0,331812,1287798,2023-06-17,2023-06-17,
40906174,0,435195,1722993,2023-06-18,2023-06-18,
40906174,464630,0,1258363,2023-06-18,2023-06-18,Utilities
40906174,0,427870,1686233,2023-06-19,2023-06-19,
40906174,337503,0,1348730,2023-06-19,2023-06-19,Bill Sharing
40906174,0,19708,1368438,2023-06-20,2023-06-20,
40906174,422960,0,945478,2023-06-21,2023-06-21,Groceries
40906174,0,301474,1246952,2023-06-21,2023-06-21,
40906174,0,351693,1598645,2023-06-21,2023-06-21,
40906174,490677,0,1107968,2023-06-22,2023-06-22,Utilities
40906174,0,388197,1496165,2023-06-23,2023-06-23,
40906174,360151,0,1136014,2023-06-24,2023-06-24,Bill Sharing
40906174,322977,0,813037,2023-06-24,2023-06-24,Entertainment
40906174,17178,0,795859,2023-06-25,2023-06-25,Bill Sharing
40906174,0,465526,1261385,2023-06-25,2023-06-25,
40906174,0,334232,1595617,2023-06-26,2023-06-26,
40906174,371116,0,1224501,2023-06-27,2023-06-27,Utilities
40906174,0,13108,1237609,2023-06-27,2023-06-27,
40906174,0,344242,1581851,2023-06-28,2023-06-28,
40906174,0,305039,1886890,2023-06-28,2023-06-28,
40906174,10293,0,1876597,2023-06-29,2023-06-29,Utilities
40906174,17437,0,1859160,2023-06-29,2023-06-29,Clothes
40906174,325819,0,1533341,2023-06-29,2023-06-29,Groceries
40906174,0,425128,1958469,2023-06-30,2023-06-30,
40906174,0,12183,1970652,2023-06-30,2023-06-30,
40906174,0,11527,1982179,2023-06-30,2023-06-30,
40906174,392238,0,1589941,2023-07-01,2023-07-01,Healthcare
40906174,302327,0,1287614,2023-07-02,2023-07-02,Healthcare
40906174,370349,0,917265,2023-07-03,2023-07-03,Healthcare
40906174,0,404408,1321673,2023-07-03,2023-07-03,
40906174,0,17093,1338766,2023-07-04,2023-07-04,
40906174,0,440559,1779325,2023-07-04,2023-07-04,
40906174,842598,0,1763533,2023-07-05,2023-07-05,Education
40906174,0,11303,1774836,2023-07-05,2023-07-05,
40906174,11077,0,1763759,2023-07-06,2023-07-06,Healthcare
40906174,416553,0,1347206,2023-07-06,2023-07-06,Education
40906174,0,306176,1653382,2023-07-07,2023-07-07,
40906174,0,17040,1670422,2023-07-08,2023-07-08,
40906174,19643,0,1650779,2023-07-08,2023-07-08,Healthcare
40906174,0,10194,1660973,2023-07-08,2023-07-08,
40906174,0,421800,2082773,2023-07-09,2023-07-09,
40906174,313336,0,1769437,2023-07-10,2023-07-10,Groceries
40906174,446127,0,1323310,2023-07-11,2023-07-11,Education
40906174,386382,0,936928,2023-07-11,2023-07-11,Rent
40906174,0,332923,1269851,2023-07-11,2023-07-11,
40906174,14961,0,1254890,2023-07-12,2023-07-12,Healthcare
40906174,0,320986,1575876,2023-07-12,2023-07-12,
40906174,0,482986,2058862,2023-07-13,2023-07-13,
40906174,12742,0,2046120,2023-07-14,2023-07-14,Clothes
40906174,11021,0,2035099,2023-07-14,2023-07-14,Clothes
40906174,0,363985,2399084,2023-07-15,2023-07-15,
40906174,328672,0,2070412,2023-07-15,2023-07-15,Rent
40906174,365662,0,1704750,2023-07-15,2023-07-15,Groceries
40906174,380842,0,1323908,2023-07-16,2023-07-16,Utilities
40906174,13640,0,1310268,2023-07-16,2023-07-16,Transportation
40906174,10302,0,1299966,2023-07-17,2023-07-17,Transportation
40906174,493970,0,805996,2023-07-17,2023-07-17,Healthcare
40906174,441267,0,364729,2023-07-18,2023-07-18,Bill Sharing
40906174,0,440423,805152,2023-07-18,2023-07-18,
40906174,0,413400,1218552,2023-07-19,2023-07-19,
40906174,371970,0,846582,2023-07-19,2023-07-19,Entertainment
40906174,18812,0,827770,2023-07-19,2023-07-19,Entertainment
40906174,0,14545,842315,2023-07-20,2023-07-20,
40906174,0,11355,853670,2023-07-20,2023-07-20,
40906174,16323,0,837347,2023-07-20,2023-07-20,Clothes
40906174,15068,0,822279,2023-07-21,2023-07-21,Utilities
40906174,475632,0,346647,2023-07-21,2023-07-21,Education
40906174,0,334147,680794,2023-07-21,2023-07-21,
40906174,336591,0,344203,2023-07-22,2023-07-22,Groceries
40906174,0,19664,363867,2023-07-23,2023-07-23,
40906174,14113,0,349754,2023-07-23,2023-07-23,Rent
40906174,0,469820,819574,2023-07-23,2023-07-23,
40906174,356920,0,462654,2023-07-24,2023-07-24,Entertainment
40906174,0,11985,474639,2023-07-24,2023-07-24,
40906174,0,12972,487611,2023-07-24,2023-07-24,
40906174,0,312329,799940,2023-07-25,2023-07-25,
40906174,0,390972,1190912,2023-07-25,2023-07-25,
40906174,0,318298,1509210,2023-07-25,2023-07-25,
40906174,0,486394,1995604,2023-07-26,2023-07-26,
40906174,313460,0,1682144,2023-07-27,2023-07-27,Rent
40906174,0,334695,2016839,2023-07-27,2023-07-27,
40906174,300478,0,1716361,2023-07-27,2023-07-27,Clothes
40906174,445821,0,1270540,2023-07-28,2023-07-28,Transportation
40906174,0,482186,1752726,2023-07-28,2023-07-28,
40906174,392601,0,1360125,2023-07-28,2023-07-28,Entertainment
40906174,0,418500,1778625,2023-07-29,2023-07-29,
40906174,354951,0,1423674,2023-07-29,2023-07-29,Groceries
40906174,0,13018,1436692,2023-07-30,2023-07-30,
40906174,0,17670,1454362,2023-07-31,2023-07-31,
40906174,457454,0,996908,2023-08-01,2023-08-01,Entertainment
40906174,0,13613,1010521,2023-08-02,2023-08-02,
40906174,414750,0,595771,2023-08-02,2023-08-02,Groceries
40906174,0,335862,931633,2023-08-02,2023-08-02,
40906174,0,392739,1324372,2023-08-03,2023-08-03,
40906174,19247,0,1305125,2023-08-03,2023-08-03,Utilities
40906174,14237,0,1290888,2023-08-03,2023-08-03,Bill Sharing
40906174,0,11528,1302416,2023-08-04,2023-08-04,
40906174,0,321494,1623910,2023-08-04,2023-08-04,
40906174,496175,0,1127735,2023-08-04,2023-08-04,Clothes
40906174,0,412756,1540491,2023-08-05,2023-08-05,
40906174,0,14066,1554557,2023-08-05,2023-08-05,
40906174,355341,0,1199216,2023-08-05,2023-08-05,Transportation
40906174,0,478285,1677501,2023-08-06,2023-08-06,
40906174,0,496190,2173691,2023-08-07,2023-08-07,
40906174,0,16032,2189723,2023-08-08,2023-08-08,
40906174,0,450825,2640548,2023-08-08,2023-08-08,
40906174,452998,0,2187550,2023-08-08,2023-08-08,Groceries
40906174,0,462210,2649760,2023-08-09,2023-08-09,
40906174,0,470009,3119769,2023-08-09,2023-08-09,
40906174,339277,0,2780492,2023-08-09,2023-08-09,Healthcare
40906174,17082,0,2763410,2023-08-10,2023-08-10,Entertainment
40906174,361759,0,2401651,2023-08-10,2023-08-10,Utilities
40906174,348156,0,2053495,2023-08-10,2023-08-10,Transportation
40906174,0,395434,2448929,2023-08-11,2023-08-11,
40906174,14459,0,2434470,2023-08-11,2023-08-11,Education
40906174,13942,0,2420528,2023-08-12,2023-08-12,Rent
40906174,0,16346,2436874,2023-08-12,2023-08-12,
40906174,10099,0,2426775,2023-08-12,2023-08-12,Utilities
40906174,487355,0,1939420,2023-08-13,2023-08-13,Healthcare
40906174,19319,0,1920101,2023-08-13,2023-08-13,Clothes
40906174,17213,0,1902888,2023-08-14,2023-08-14,Healthcare
40906174,16240,0,1886648,2023-08-14,2023-08-14,Clothes
40906174,12496,0,1874152,2023-08-15,2023-08-15,Rent
40906174,328060,0,1546092,2023-08-15,2023-08-15,Transportation
40906174,0,335654,1881746,2023-08-15,2023-08-15,
40906174,0,17615,1899361,2023-08-16,2023-08-16,
40906174,387452,0,1511909,2023-08-16,2023-08-16,Healthcare
40906174,12240,0,1499669,2023-08-16,2023-08-16,Clothes
40906174,0,14119,1513788,2023-08-17,2023-08-17,
40906174,388855,0,1124933,2023-08-18,2023-08-18,Groceries
40906174,0,391196,1516129,2023-08-18,2023-08-18,
40906174,358707,0,1157422,2023-08-19,2023-08-19,Clothes
40906174,415209,0,742213,2023-08-19,2023-08-19,Transportation
40906174,11522,0,730691,2023-08-19,2023-08-19,Groceries
40906174,0,333575,1064266,2023-08-20,2023-08-20,
40906174,0,457016,1521282,2023-08-20,2023-08-20,
40906174,400667,0,1120615,2023-08-20,2023-08-20,Healthcare
40906174,454542,0,666073,2023-08-21,2023-08-21,Clothes
40906174,480403,0,185670,2023-08-21,2023-08-21,Entertainment
40906174,19362,0,166308,2023-08-22,2023-08-22,Bill Sharing
40906174,12874,0,153434,2023-08-22,2023-08-22,Groceries
40906174,0,19291,172725,2023-08-23,2023-08-23,
40906174,396771,0,10000,2023-08-24,2023-08-24,Bill Sharing
40906174,17825,0,10000,2023-08-24,2023-08-24,Education
40906174,384704,0,10000,2023-08-24,2023-08-24,Transportation
40906174,0,496018,506018,2023-08-25,2023-08-25,
40906174,0,19302,525320,2023-08-25,2023-08-25,
40906174,0,451957,977277,2023-08-25,2023-08-25,
40906174,385497,0,591780,2023-08-26,2023-08-26,Healthcare
40906174,0,16269,608049,2023-08-26,2023-08-26,
40906174,12730,0,595319,2023-08-27,2023-08-27,Healthcare
40906174,380450,0,214869,2023-08-27,2023-08-27,Entertainment
40906174,13982,0,200887,2023-08-27,2023-08-27,Entertainment
40906174,444610,0,10000,2023-08-28,2023-08-28,Utilities
40906174,342335,0,10000,2023-08-28,2023-08-28,Bill Sharing
40906174,405632,0,10000,2023-08-29,2023-08-29,Clothes
40906174,0,324608,334608,2023-08-29,2023-08-29,
40906174,0,458166,792774,2023-08-30,2023-08-30,
40906174,0,336966,1129740,2023-08-30,2023-08-30,
40906174,19824,0,1109916,2023-08-31,2023-08-31,Education
40906174,0,484452,1594368,2023-08-31,2023-08-31,
40906174,0,13841,1608209,2023-08-31,2023-08-31,
40906174,18739,0,1589470,2023-09-01,2023-09-01,Utilities
40906174,348798,0,1240672,2023-09-01,2023-09-01,Healthcare
40906174,337965,0,902707,2023-09-01,2023-09-01,Utilities
40906174,0,359795,1262502,2023-09-02,2023-09-02,
40906174,16116,0,1246386,2023-09-02,2023-09-02,Entertainment
40906174,0,321507,1567893,2023-09-02,2023-09-02,
40906174,0,372274,1940167,2023-09-03,2023-09-03,
40906174,15225,0,1924942,2023-09-04,2023-09-04,Transportation
40906174,487133,0,1437809,2023-09-04,2023-09-04,Transportation
40906174,0,19285,1457094,2023-09-05,2023-09-05,
40906174,17903,0,1439191,2023-09-05,2023-09-05,Clothes
40906174,15104,0,1424087,2023-09-06,2023-09-06,Transportation
40906174,0,17007,1441094,2023-09-06,2023-09-06,
40906174,0,442174,1883268,2023-09-07,2023-09-07,
40906174,550673,0,1471207,2023-09-08,2023-09-08,Education
40906174,407922,0,1063285,2023-09-09,2023-09-09,Education
40906174,349143,0,714142,2023-09-10,2023-09-10,Rent
40906174,364211,0,349931,2023-09-10,2023-09-10,Entertainment
40906174,360300,0,10000,2023-09-10,2023-09-10,Education
40906174,10824,0,10000,2023-09-11,2023-09-11,Groceries
40906174,0,426434,436434,2023-09-12,2023-09-12,
40906174,0,19029,455463,2023-09-12,2023-09-12,
40906174,10610,0,444853,2023-09-12,2023-09-12,Healthcare
40906174,0,470780,915633,2023-09-13,2023-09-13,
40906174,0,461490,1377123,2023-09-13,2023-09-13,
40906174,16254,0,1360869,2023-09-14,2023-09-14,Healthcare
40906174,15062,0,1345807,2023-09-15,2023-09-15,Healthcare
40906174,463188,0,882619,2023-09-15,2023-09-15,Clothes
40906174,0,16938,899557,2023-09-15,2023-09-15,
40906174,0,11493,911050,2023-09-16,2023-09-16,
40906174,0,12821,923871,2023-09-17,2023-09-17,
40906174,333927,0,589944,2023-09-17,2023-09-17,Entertainment
40906174,410205,0,179739,2023-09-17,2023-09-17,Transportation
40906174,340083,0,10000,2023-09-18,2023-09-18,Entertainment
40906174,0,19070,29070,2023-09-19,2023-09-19,
40906174,0,406994,436064,2023-09-19,2023-09-19,
40906174,15470,0,420594,2023-09-19,2023-09-19,Healthcare
40906174,319938,0,100656,2023-09-20,2023-09-20,Clothes
40906174,725029,0,117089,2023-09-21,2023-09-21,Healthcare
40906174,0,19461,136550,2023-09-21,2023-09-21,
40906174,19178,0,117372,2023-09-22,2023-09-22,Rent
40906174,0,17845,135217,2023-09-22,2023-09-22,
40906174,14303,0,120914,2023-09-22,2023-09-22,Clothes
40906174,0,15807,136721,2023-09-23,2023-09-23,
40906174,0,14733,151454,2023-09-23,2023-09-23,
40906174,0,18721,170175,2023-09-23,2023-09-23,
40906174,365884,0,10000,2023-09-24,2023-09-24,Bill Sharing
40906174,0,14772,24772,2023-09-25,2023-09-25,
40906174,0,828689,10000,2023-09-25,2023-09-25,
40906174,11079,0,10000,2023-09-26,2023-09-26,Utilities
40906174,19956,0,10000,2023-09-26,2023-09-26,Bill Sharing
40906174,16822,0,10000,2023-09-26,2023-09-26,Healthcare
40906174,11059,0,10000,2023-09-27,2023-09-27,Education
40906174,0,638477,10000,2023-09-28,2023-09-28,
40906174,0,325389,335389,2023-09-29,2023-09-29,
40906174,18635,0,316754,2023-09-29,2023-09-29,Utilities
40906174,440217,0,10000,2023-09-30,2023-09-30,Healthcare
40906174,0,337199,347199,2023-09-30,2023-09-30,
40906174,14213,0,332986,2023-10-01,2023-10-01,Bill Sharing
40906174,10151,0,322835,2023-10-02,2023-10-02,Utilities
40906174,693320,0,339927,2023-10-02,2023-10-02,Healthcare
40906174,524007,0,804328,2023-10-03,2023-10-03,Education
40906174,0,18211,822539,2023-10-03,2023-10-03,
40906174,0,17309,839848,2023-10-03,2023-10-03,
40906174,14192,0,825656,2023-10-04,2023-10-04,Rent
40906174,0,484821,1310477,2023-10-05,2023-10-05,
40906174,0,13412,1323889,2023-10-05,2023-10-05,
40906174,467357,0,856532,2023-10-06,2023-10-06,Utilities
40906174,0,14489,871021,2023-10-06,2023-10-06,
40906174,430449,0,440572,2023-10-07,2023-10-07,Transportation
40906174,461569,0,10000,2023-10-08,2023-10-08,Groceries
40906174,0,19297,29297,2023-10-08,2023-10-08,
40906174,10850,0,18447,2023-10-09,2023-10-09,Utilities
40906174,17577,0,10000,2023-10-09,2023-10-09,Utilities
40906174,18481,0,10000,2023-10-10,2023-10-10,Clothes
40906174,0,19167,29167,2023-10-11,2023-10-11,
40906174,0,13552,42719,2023-10-11,2023-10-11,
40906174,350938,0,10000,2023-10-11,2023-10-11,Groceries
40906174,327882,0,10000,2023-10-12,2023-10-12,Utilities
40906174,0,342804,352804,2023-10-13,2023-10-13,
40906174,0,446775,802696,2023-10-14,2023-10-14,
40906174,422271,0,380425,2023-10-14,2023-10-14,Healthcare
40906174,0,418453,798878,2023-10-14,2023-10-14,
40906174,0,381028,1179906,2023-10-15,2023-10-15,
40906174,332521,0,847385,2023-10-16,2023-10-16,Bill Sharing
40906174,659517,0,861333,2023-10-16,2023-10-16,Education
40906174,11650,0,849683,2023-10-16,2023-10-16,Transportation
40906174,0,309357,1159040,2023-10-17,2023-10-17,
40906174,11068,0,1147972,2023-10-18,2023-10-18,Transportation
40906174,443293,0,704679,2023-10-19,2023-10-19,Entertainment
40906174,0,18753,723432,2023-10-19,2023-10-19,
40906174,436621,0,286811,2023-10-20,2023-10-20,Transportation
40906174,16138,0,270673,2023-10-21,2023-10-21,Education
40906174,0,11120,281793,2023-10-22,2023-10-22,
40906174,0,397145,678938,2023-10-23,2023-10-23,
40906174,0,324023,1002961,2023-10-24,2023-10-24,
40906174,12877,0,990084,2023-10-25,2023-10-25,Clothes
40906174,0,495624,1485708,2023-10-26,2023-10-26,
40906174,328612,0,1157096,2023-10-27,2023-10-27,Transportation
40906174,404689,0,752407,2023-10-27,2023-10-27,Bill Sharing
40906174,416991,0,335416,2023-10-28,2023-10-28,Education
40906174,0,13411,348827,2023-10-28,2023-10-28,
40906174,0,481847,830674,2023-10-28,2023-10-28,
40906174,0,15055,845729,2023-10-29,2023-10-29,
40906174,0,336161,1181890,2023-10-30,2023-10-30,
40906174,0,457019,1638909,2023-10-31,2023-10-31,
40906174,11285,0,1627624,2023-10-31,2023-10-31,Bill Sharing
40906174,440195,0,1187429,2023-10-31,2023-10-31,Bill Sharing
40906174,401131,0,786298,2023-11-01,2023-11-01,Rent
40906174,375521,0,410777,2023-11-02,2023-11-02,Healthcare
40906174,0,453967,864744,2023-11-02,2023-11-02,
40906174,760201,0,849069,2023-11-02,2023-11-02,Education
40906174,13194,0,835875,2023-11-03,2023-11-03,Utilities
40906174,0,375983,1211858,2023-11-04,2023-11-04,
40906174,412242,0,799616,2023-11-05,2023-11-05,Healthcare
40906174,0,413976,1213592,2023-11-06,2023-11-06,
40906174,0,478076,1691668,2023-11-06,2023-11-06,
40906174,0,376914,2068582,2023-11-07,2023-11-07,
40906174,470593,0,1597989,2023-11-07,2023-11-07,Utilities
40906174,0,480852,2078841,2023-11-07,2023-11-07,
40906174,11291,0,2067550,2023-11-08,2023-11-08,Bill Sharing
40906174,337932,0,1729618,2023-11-09,2023-11-09,Rent
40906174,16733,0,1712885,2023-11-10,2023-11-10,Transportation
40906174,431859,0,1281026,2023-11-10,2023-11-10,Utilities
40906174,0,468648,1749674,2023-11-10,2023-11-10,
40906174,0,16006,1765680,2023-11-11,2023-11-11,
40906174,11597,0,1754083,2023-11-11,2023-11-11,Healthcare
40906174,0,355499,2109582,2023-11-12,2023-11-12,
40906174,373523,0,1736059,2023-11-13,2023-11-13,Bill Sharing
40906174,0,623494,1722320,2023-11-13,2023-11-13,
40906174,0,15302,1737622,2023-11-14,2023-11-14,
40906174,399441,0,1338181,2023-11-14,2023-11-14,Bill Sharing
40906174,0,392657,1730838,2023-11-14,2023-11-14,
40906174,0,302867,2033705,2023-11-15,2023-11-15,
40906174,0,19700,2053405,2023-11-15,2023-11-15,
40906174,0,10275,2063680,2023-11-15,2023-11-15,
40906174,323210,0,1740470,2023-11-16,2023-11-16,Clothes
40906174,0,436251,2176721,2023-11-17,2023-11-17,
40906174,0,451382,2628103,2023-11-17,2023-11-17,
40906174,0,15611,2643714,2023-11-18,2023-11-18,
40906174,0,11011,2654725,2023-11-18,2023-11-18,
40906174,0,19120,2673845,2023-11-19,2023-11-19,
40906174,0,458565,3132410,2023-11-19,2023-11-19,
40906174,365681,0,2766729,2023-11-20,2023-11-20,Education
40906174,0,491646,3258375,2023-11-21,2023-11-21,
40906174,12369,0,3246006,2023-11-22,2023-11-22,Groceries
40906174,0,311765,3557771,2023-11-22,2023-11-22,
40906174,10546,0,3547225,2023-11-23,2023-11-23,Healthcare
40906174,0,330343,3877568,2023-11-23,2023-11-23,
40906174,476781,0,3400787,2023-11-24,2023-11-24,Education
40906174,407530,0,2993257,2023-11-24,2023-11-24,Education
40906174,0,368898,3362155,2023-11-25,2023-11-25,
40906174,0,450019,3812174,2023-11-26,2023-11-26,
40906174,0,10616,3822790,2023-11-26,2023-11-26,
40906174,0,16386,3839176,2023-11-26,2023-11-26,
40906174,695561,0,3829062,2023-11-27,2023-11-27,Education
40906174,19634,0,3809428,2023-11-27,2023-11-27,Rent
40906174,0,11728,3821156,2023-11-27,2023-11-27,
40906174,324902,0,3496254,2023-11-28,2023-11-28,Utilities
40906174,364918,0,3131336,2023-11-28,2023-11-28,Utilities
40906174,0,420179,3551515,2023-11-28,2023-11-28,
40906174,12161,0,3539354,2023-11-29,2023-11-29,Utilities
40906174,0,377063,3916417,2023-11-29,2023-11-29,
40906174,0,312707,4229124,2023-11-30,2023-11-30,
40906174,18376,0,4210748,2023-12-01,2023-12-01,Clothes
40906174,352668,0,3858080,2023-12-01,2023-12-01,Education
40906174,0,376151,4234231,2023-12-01,2023-12-01,
40906174,0,15337,4249568,2023-12-02,2023-12-02,
40906174,0,14398,4263966,2023-12-03,2023-12-03,
40906174,0,10142,4274108,2023-12-03,2023-12-03,
40906174,0,415520,4689628,2023-12-03,2023-12-03,
40906174,0,11305,4700933,2023-12-04,2023-12-04,
40906174,0,396047,5096980,2023-12-04,2023-12-04,
40906174,0,321455,5418435,2023-12-05,2023-12-05,
40906174,13802,0,5404633,2023-12-05,2023-12-05,Utilities
40906174,308959,0,5095674,2023-12-06,2023-12-06,Utilities
40906174,0,11691,5107365,2023-12-07,2023-12-07,
40906174,300945,0,4806420,2023-12-07,2023-12-07,Rent
40906174,0,18436,4824856,2023-12-07,2023-12-07,
40906174,0,19234,4844090,2023-12-08,2023-12-08,
40906174,404653,0,4439437,2023-12-08,2023-12-08,Clothes
40906174,420762,0,4018675,2023-12-08,2023-12-08,Healthcare
40906174,340861,0,3677814,2023-12-09,2023-12-09,Bill Sharing
40906174,18164,0,3659650,2023-12-09,2023-12-09,Clothes
40906174,460748,0,3198902,2023-12-09,2023-12-09,Transportation
40906174,0,13751,3212653,2023-12-10,2023-12-10,
40906174,0,15750,3228403,2023-12-10,2023-12-10,
40906174,0,10255,3238658,2023-12-11,2023-12-11,
40906174,17529,0,3221129,2023-12-12,2023-12-12,Entertainment
40906174,0,386858,3607987,2023-12-12,2023-12-12,
40906174,14040,0,3593947,2023-12-12,2023-12-12,Clothes
40906174,0,451303,4045250,2023-12-13,2023-12-13,
40906174,363428,0,3681822,2023-12-13,2023-12-13,Rent
40906174,0,451900,4133722,2023-12-13,2023-12-13,
40906174,427258,0,3706464,2023-12-14,2023-12-14,Bill Sharing
40906174,0,351453,4057917,2023-12-14,2023-12-14,
40906174,18638,0,4039279,2023-12-14,2023-12-14,Groceries
40906174,0,401327,4440606,2023-12-15,2023-12-15,
40906174,492393,0,3948213,2023-12-16,2023-12-16,Bill Sharing
40906174,310246,0,3637967,2023-12-16,2023-12-16,Transportation
40906174,0,10739,3648706,2023-12-16,2023-12-16,
40906174,11657,0,3637049,2023-12-17,2023-12-17,Entertainment
40906174,0,353677,3990726,2023-12-17,2023-12-17,
40906174,0,486122,4476848,2023-12-17,2023-12-17,
40906174,0,378160,4855008,2023-12-18,2023-12-18,
40906174,17820,0,4837188,2023-12-18,2023-12-18,Healthcare
40906174,0,448904,5286092,2023-12-18,2023-12-18,
40906174,0,377688,5663780,2023-12-19,2023-12-19,
40906174,0,373722,6037502,2023-12-19,2023-12-19,
40906174,14013,0,6023489,2023-12-19,2023-12-19,Entertainment
40906174,0,434556,6458045,2023-12-20,2023-12-20,
40906174,0,310863,6768908,2023-12-21,2023-12-21,
40906174,0,421704,7190612,2023-12-22,2023-12-22,
40906174,324247,0,6866365,2023-12-22,2023-12-22,Education
40906174,0,445486,7311851,2023-12-22,2023-12-22,
40906174,11038,0,7300813,2023-12-23,2023-12-23,Rent
40906174,0,401397,7702210,2023-12-23,2023-12-23,
40906174,16048,0,7686162,2023-12-24,2023-12-24,Clothes
40906174,0,11128,7697290,2023-12-24,2023-12-24,
40906174,0,372093,8069383,2023-12-25,2023-12-25,
40906174,15694,0,8053689,2023-12-25,2023-12-25,Utilities
40906174,0,13031,8066720,2023-12-26,2023-12-26,
40906174,13744,0,8052976,2023-12-26,2023-12-26,Groceries
40906174,0,13800,8066776,2023-12-27,2023-12-27,
40906174,0,340137,8406913,2023-12-27,2023-12-27,
40906174,0,12841,8419754,2023-12-27,2023-12-27,
40906174,0,12072,8431826,2023-12-28,2023-12-28,
40906174,12378,0,8419448,2023-12-28,2023-12-28,Bill Sharing
40906174,0,307153,8726601,2023-12-28,2023-12-28,
40906174,0,462043,9188644,2023-12-29,2023-12-29,
40906174,0,10824,9199468,2023-12-29,2023-12-29,
40906174,0,331389,9530857,2023-12-30,2023-12-30,
40906174,10512,0,9520345,2023-12-31,2023-12-31,Entertainment
40906174,0,411148,9931493,2023-12-31,2023-12-31,
40906174,0,11133,9942626,2024-01-01,2024-01-01,
40906174,0,375049,10317675,2024-01-01,2024-01-01,
40906174,0,11053,10328728,2024-01-01,2024-01-01,
40906174,0,17686,10346414,2024-01-02,2024-01-02,
40906174,399060,0,9947354,2024-01-02,2024-01-02,Utilities
40906174,0,12338,9959692,2024-01-02,2024-01-02,
40906174,0,485048,10444740,2024-01-03,2024-01-03,
40906174,358346,0,10086394,2024-01-03,2024-01-03,Transportation
40906174,11503,0,10074891,2024-01-04,2024-01-04,Transportation
40906174,0,11040,10085931,2024-01-04,2024-01-04,
40906174,0,321941,10407872,2024-01-05,2024-01-05,
40906174,0,347252,10755124,2024-01-05,2024-01-05,
40906174,15301,0,10739823,2024-01-05,2024-01-05,Clothes
40906174,0,423760,11163583,2024-01-06,2024-01-06,
40906174,0,14919,11178502,2024-01-07,2024-01-07,
40906174,17588,0,11160914,2024-01-08,2024-01-08,Groceries
40906174,433438,0,10727476,2024-01-08,2024-01-08,Transportation
40906174,0,17015,10744491,2024-01-08,2024-01-08,
40906174,438340,0,10306151,2024-01-09,2024-01-09,Rent
40906174,0,319580,10625731,2024-01-09,2024-01-09,
40906174,479185,0,10146546,2024-01-10,2024-01-10,Healthcare
40906174,0,12939,10159485,2024-01-10,2024-01-10,
40906174,0,15855,10175340,2024-01-10,2024-01-10,
40906174,10709,0,10164631,2024-01-11,2024-01-11,Groceries
40906174,0,15376,10180007,2024-01-11,2024-01-11,
40906174,394074,0,9785933,2024-01-11,2024-01-11,Rent
40906174,0,19087,9805020,2024-01-12,2024-01-12,
40906174,0,13457,9818477,2024-01-13,2024-01-13,
40906174,446948,0,9371529,2024-01-14,2024-01-14,Entertainment
40906174,384614,0,8986915,2024-01-14,2024-01-14,Bill Sharing
40906174,486181,0,8500734,2024-01-14,2024-01-14,Bill Sharing
40906174,11016,0,8489718,2024-01-15,2024-01-15,Entertainment
40906174,300335,0,8189383,2024-01-16,2024-01-16,Utilities
40906174,0,457004,8646387,2024-01-16,2024-01-16,
40906174,429871,0,8216516,2024-01-17,2024-01-17,Rent
40906174,0,439919,8656435,2024-01-17,2024-01-17,
40906174,433607,0,8222828,2024-01-17,2024-01-17,Rent
40906174,480702,0,7742126,2024-01-18,2024-01-18,Utilities
40906174,0,559134,8204864,2024-01-18,2024-01-18,
40906174,0,390712,8595576,2024-01-19,2024-01-19,
40906174,0,499723,9095299,2024-01-19,2024-01-19,
40906174,0,13183,9108482,2024-01-20,2024-01-20,
40906174,0,17969,9126451,2024-01-20,2024-01-20,
40906174,0,325212,9451663,2024-01-21,2024-01-21,
40906174,0,16820,9468483,2024-01-22,2024-01-22,
40906174,494198,0,8974285,2024-01-22,2024-01-22,Entertainment
40906174,0,430897,9405182,2024-01-22,2024-01-22,
40906174,355523,0,9049659,2024-01-23,2024-01-23,Rent
40906174,13425,0,9036234,2024-01-23,2024-01-23,Clothes
40906174,302653,0,8733581,2024-01-24,2024-01-24,Education
40906174,0,418488,9152069,2024-01-25,2024-01-25,
40906174,372358,0,8779711,2024-01-25,2024-01-25,Healthcare
40906174,496295,0,8283416,2024-01-26,2024-01-26,Healthcare
40906174,371809,0,7911607,2024-01-26,2024-01-26,Rent
40906174,0,19832,7931439,2024-01-26,2024-01-26,
40906174,0,588165,7488197,2024-01-27,2024-01-27,
40906174,0,12377,7500574,2024-01-27,2024-01-27,
40906174,0,346674,7847248,2024-01-27,2024-01-27,
40906174,0,15752,7863000,2024-01-28,2024-01-28,
40906174,15756,0,7847244,2024-01-29,2024-01-29,Education
40906174,0,494817,8342061,2024-01-30,2024-01-30,
40906174,0,15920,8357981,2024-01-30,2024-01-30,
40906174,431934,0,7926047,2024-01-31,2024-01-31,Rent
40906174,0,410678,8336725,2024-02-01,2024-02-01,
40906174,12130,0,8324595,2024-02-01,2024-02-01,Rent
40906174,0,386061,8710656,2024-02-01,2024-02-01,
40906174,15170,0,8695486,2024-02-02,2024-02-02,Clothes
40906174,377635,0,8317851,2024-02-03,2024-02-03,Clothes
40906174,15322,0,8302529,2024-02-04,2024-02-04,Transportation
40906174,0,10589,8313118,2024-02-04,2024-02-04,
40906174,0,472568,8785686,2024-02-05,2024-02-05,
40906174,11086,0,8774600,2024-02-06,2024-02-06,Entertainment
40906174,0,353286,9127886,2024-02-07,2024-02-07,
40906174,392401,0,8735485,2024-02-07,2024-02-07,Transportation
40906174,478917,0,8256568,2024-02-07,2024-02-07,Entertainment
40906174,0,13310,8269878,2024-02-08,2024-02-08,
40906174,0,19456,8289334,2024-02-08,2024-02-08,
40906174,601518,0,8678859,2024-02-09,2024-02-09,Healthcare
40906174,0,14098,8692957,2024-02-10,2024-02-10,
40906174,15770,0,8677187,2024-02-11,2024-02-11,Bill Sharing
40906174,393029,0,8284158,2024-02-12,2024-02-12,Bill Sharing
40906174,407136,0,7877022,2024-02-12,2024-02-12,Groceries
40906174,392326,0,7484696,2024-02-12,2024-02-12,Clothes
40906174,16941,0,7467755,2024-02-13,2024-02-13,Bill Sharing
40906174,362377,0,7105378,2024-02-14,2024-02-14,Rent
40906174,0,11852,7117230,2024-02-14,2024-02-14,
40906174,16803,0,7100427,2024-02-14,2024-02-14,Transportation
40906174,0,457260,7557687,2024-02-15,2024-02-15,
40906174,0,463790,8021477,2024-02-16,2024-02-16,
40906174,0,10031,8031508,2024-02-17,2024-02-17,
40906174,0,367896,8399404,2024-02-17,2024-02-17,
40906174,0,11087,8410491,2024-02-18,2024-02-18,
40906174,18361,0,8392130,2024-02-18,2024-02-18,Healthcare
40906174,0,485199,8877329,2024-02-19,2024-02-19,
40906174,310820,0,8566509,2024-02-19,2024-02-19,Clothes
40906174,977209,0,8931486,2024-02-19,2024-02-19,Healthcare
40906174,12417,0,8919069,2024-02-20,2024-02-20,Healthcare
40906174,453843,0,8465226,2024-02-20,2024-02-20,Bill Sharing
40906174,17996,0,8447230,2024-02-20,2024-02-20,Rent
40906174,358739,0,8088491,2024-02-21,2024-02-21,Education
40906174,0,10685,8099176,2024-02-22,2024-02-22,
40906174,412201,0,7686975,2024-02-22,2024-02-22,Entertainment
40906174,12920,0,7674055,2024-02-22,2024-02-22,Clothes
40906174,0,18050,7692105,2024-02-23,2024-02-23,
40906174,424029,0,7268076,2024-02-24,2024-02-24,Bill Sharing
40906174,0,12577,7280653,2024-02-24,2024-02-24,
40906174,342004,0,6938649,2024-02-25,2024-02-25,Healthcare
40906174,13050,0,6925599,2024-02-25,2024-02-25,Bill Sharing
40906174,0,478636,7404235,2024-02-25,2024-02-25,
40906174,0,300049,7704284,2024-02-26,2024-02-26,
40906174,422696,0,7281588,2024-02-27,2024-02-27,Education
40906174,0,454344,7735932,2024-02-28,2024-02-28,
40906174,0,455177,8191109,2024-02-28,2024-02-28,
40906174,0,12599,8203708,2024-02-29,2024-02-29,
40906174,14611,0,8189097,2024-03-01,2024-03-01,Entertainment
40906174,307330,0,7881767,2024-03-01,2024-03-01,Entertainment
40906174,0,300511,8182278,2024-03-01,2024-03-01,
40906174,402039,0,7780239,2024-03-02,2024-03-02,Entertainment
40906174,300417,0,7479822,2024-03-02,2024-03-02,Healthcare
40906174,399850,0,7079972,2024-03-03,2024-03-03,Clothes
40906174,0,325197,7405169,2024-03-03,2024-03-03,
40906174,18272,0,7386897,2024-03-04,2024-03-04,Education
40906174,0,434496,7821393,2024-03-04,2024-03-04,
40906174,0,320162,8141555,2024-03-04,2024-03-04,
40906174,0,304504,8446059,2024-03-05,2024-03-05,
40906174,366288,0,8079771,2024-03-06,2024-03-06,Rent
40906174,11641,0,8068130,2024-03-07,2024-03-07,Education
40906174,0,16171,8084301,2024-03-07,2024-03-07,
40906174,11092,0,8073209,2024-03-07,2024-03-07,Utilities
40906174,14511,0,8058698,2024-03-08,2024-03-08,Education
40906174,15885,0,8042813,2024-03-08,2024-03-08,Healthcare
40906174,0,19637,8062450,2024-03-09,2024-03-09,
40906174,479713,0,7582737,2024-03-09,2024-03-09,Education
40906174,402618,0,7180119,2024-03-10,2024-03-10,Rent
40906174,15681,0,7164438,2024-03-10,2024-03-10,Utilities
40906174,14432,0,7150006,2024-03-11,2024-03-11,Education
40906174,0,14942,7164948,2024-03-11,2024-03-11,
40906174,0,18715,7183663,2024-03-12,2024-03-12,
40906174,0,18403,7202066,2024-03-12,2024-03-12,
40906174,471171,0,6730895,2024-03-12,2024-03-12,Rent
40906174,0,331999,7062894,2024-03-13,2024-03-13,
40906174,15536,0,7047358,2024-03-13,2024-03-13,Education
40906174,0,359692,7407050,2024-03-13,2024-03-13,
40906174,333416,0,7073634,2024-03-14,2024-03-14,Clothes
40906174,339065,0,6734569,2024-03-14,2024-03-14,Groceries
40906174,0,10777,6745346,2024-03-15,2024-03-15,
40906174,12696,0,6732650,2024-03-16,2024-03-16,Clothes
40906174,0,12984,6745634,2024-03-16,2024-03-16,
40906174,424001,0,6321633,2024-03-17,2024-03-17,Rent
40906174,0,460772,6782405,2024-03-18,2024-03-18,
40906174,0,387060,7169465,2024-03-18,2024-03-18,
40906174,10147,0,7159318,2024-03-18,2024-03-18,Groceries
40906174,12514,0,7146804,2024-03-19,2024-03-19,Education
40906174,10426,0,7136378,2024-03-19,2024-03-19,Entertainment
40906174,10861,0,7125517,2024-03-19,2024-03-19,Healthcare
40906174,0,499387,7624904,2024-03-20,2024-03-20,
40906174,12854,0,7612050,2024-03-20,2024-03-20,Clothes
40906174,498649,0,7113401,2024-03-21,2024-03-21,Utilities
40906174,302168,0,6811233,2024-03-21,2024-03-21,Healthcare
40906174,0,303535,7114768,2024-03-21,2024-03-21,
40906174,459236,0,6655532,2024-03-22,2024-03-22,Rent
40906174,0,13888,6669420,2024-03-23,2024-03-23,
40906174,0,11119,6680539,2024-03-24,2024-03-24,
40906174,0,303568,6984107,2024-03-24,2024-03-24,
40906174,426877,0,6557230,2024-03-24,2024-03-24,Clothes
40906174,0,12234,6569464,2024-03-25,2024-03-25,
40906174,0,486754,7056218,2024-03-25,2024-03-25,
40906174,11610,0,7044608,2024-03-25,2024-03-25,Bill Sharing
40906174,0,459675,7504283,2024-03-26,2024-03-26,
40906174,0,305456,7809739,2024-03-26,2024-03-26,
40906174,361843,0,7447896,2024-03-27,2024-03-27,Healthcare
40906174,404285,0,7043611,2024-03-27,2024-03-27,Utilities
40906174,11998,0,7031613,2024-03-28,2024-03-28,Bill Sharing
40906174,0,552874,6615535,2024-03-29,2024-03-29,
40906174,0,19824,6635359,2024-03-29,2024-03-29,
40906174,0,18155,6653514,2024-03-29,2024-03-29,
40906174,445302,0,6208212,2024-03-30,2024-03-30,Groceries
40906174,421164,0,5787048,2024-03-31,2024-03-31,Groceries
40906174,472529,0,5314519,2024-03-31,2024-03-31,Bill Sharing
40906174,0,18270,5332789,2024-04-01,2024-04-01,
40906174,359319,0,4973470,2024-04-01,2024-04-01,Utilities
40906174,0,12439,4985909,2024-04-01,2024-04-01,
40906174,328238,0,4657671,2024-04-02,2024-04-02,Groceries
40906174,315779,0,4341892,2024-04-02,2024-04-02,Bill Sharing
40906174,18417,0,4323475,2024-04-03,2024-04-03,Rent
40906174,0,19287,4342762,2024-04-03,2024-04-03,
40906174,0,11518,4354280,2024-04-04,2024-04-04,
40906174,403913,0,3950367,2024-04-04,2024-04-04,Utilities
40906174,303356,0,3647011,2024-04-04,2024-04-04,Education
40906174,367468,0,3279543,2024-04-05,2024-04-05,Transportation
40906174,15009,0,3264534,2024-04-05,2024-04-05,Rent
40906174,0,15988,3280522,2024-04-05,2024-04-05,
40906174,10901,0,3269621,2024-04-06,2024-04-06,Transportation
40906174,645247,0,3258301,2024-04-07,2024-04-07,Healthcare
40906174,356081,0,2902220,2024-04-08,2024-04-08,Rent
40906174,0,403655,3305875,2024-04-08,2024-04-08,
40906174,0,326721,3632596,2024-04-08,2024-04-08,
40906174,0,13828,3646424,2024-04-09,2024-04-09,
40906174,18883,0,3627541,2024-04-10,2024-04-10,Bill Sharing
40906174,342663,0,3284878,2024-04-10,2024-04-10,Clothes
40906174,0,398085,3682963,2024-04-11,2024-04-11,
40906174,12882,0,3670081,2024-04-12,2024-04-12,Rent
40906174,0,333721,4003802,2024-04-12,2024-04-12,
40906174,417119,0,3586683,2024-04-13,2024-04-13,Healthcare
40906174,10049,0,3576634,2024-04-13,2024-04-13,Clothes
40906174,577490,0,3563001,2024-04-13,2024-04-13,Education
40906174,0,475145,4038146,2024-04-14,2024-04-14,
40906174,477873,0,3560273,2024-04-15,2024-04-15,Education
40906174,0,403012,3963285,2024-04-15,2024-04-15,
40906174,10233,0,3953052,2024-04-16,2024-04-16,Rent
40906174,12370,0,3940682,2024-04-16,2024-04-16,Bill Sharing
40906174,13919,0,3926763,2024-04-17,2024-04-17,Rent
40906174,0,19627,3946390,2024-04-18,2024-04-18,
40906174,393085,0,3553305,2024-04-18,2024-04-18,Entertainment
40906174,0,12776,3566081,2024-04-18,2024-04-18,
40906174,0,497385,4063466,2024-04-19,2024-04-19,
40906174,422365,0,3641101,2024-04-19,2024-04-19,Entertainment
40906174,0,444137,4085238,2024-04-20,2024-04-20,
40906174,0,427276,4512514,2024-04-20,2024-04-20,
40906174,0,400572,4913086,2024-04-21,2024-04-21,
40906174,459398,0,4453688,2024-04-21,2024-04-21,Healthcare
40906174,0,410630,4864318,2024-04-21,2024-04-21,
40906174,0,10658,4874976,2024-04-22,2024-04-22,
40906174,380827,0,4494149,2024-04-22,2024-04-22,Entertainment
40906174,13135,0,4481014,2024-04-22,2024-04-22,Groceries
40906174,10600,0,4470414,2024-04-23,2024-04-23,Transportation
40906174,0,485846,4956260,2024-04-24,2024-04-24,
40906174,453858,0,4502402,2024-04-24,2024-04-24,Clothes
40906174,349917,0,4152485,2024-04-25,2024-04-25,Entertainment
40906174,354858,0,3797627,2024-04-25,2024-04-25,Utilities
40906174,497587,0,3300040,2024-04-25,2024-04-25,Education
40906174,0,440461,3740501,2024-04-26,2024-04-26,
40906174,0,579353,4157767,2024-04-27,2024-04-27,
40906174,0,18300,4176067,2024-04-28,2024-04-28,
40906174,346556,0,3829511,2024-04-28,2024-04-28,Clothes
40906174,0,17628,3847139,2024-04-29,2024-04-29,
40906174,0,315791,4162930,2024-04-29,2024-04-29,
40906174,467968,0,3694962,2024-04-30,2024-04-30,Education
40906174,414482,0,3280480,2024-04-30,2024-04-30,Rent
40906174,15236,0,3265244,2024-04-30,2024-04-30,Entertainment
40906174,15937,0,3249307,2024-05-01,2024-05-01,Education
40906174,0,10920,3260227,2024-05-01,2024-05-01,
40906174,321923,0,2938304,2024-05-01,2024-05-01,Education
40906174,0,354572,3292876,2024-05-02,2024-05-02,
40906174,396852,0,2896024,2024-05-03,2024-05-03,Groceries
40906174,391135,0,2504889,2024-05-04,2024-05-04,Clothes
40906174,13985,0,2490904,2024-05-04,2024-05-04,Healthcare
40906174,419893,0,2071011,2024-05-04,2024-05-04,Groceries
40906174,18513,0,2052498,2024-05-05,2024-05-05,Utilities
40906174,10961,0,2041537,2024-05-05,2024-05-05,Education
40906174,0,11261,2052798,2024-05-05,2024-05-05,
40906174,0,413731,2466529,2024-05-06,2024-05-06,
40906174,10852,0,2455677,2024-05-06,2024-05-06,Rent
40906174,0,19986,2475663,2024-05-06,2024-05-06,
40906174,0,306646,2782309,2024-05-07,2024-05-07,
40906174,11837,0,2770472,2024-05-07,2024-05-07,Education
40906174,0,466228,2354297,2024-05-07,2024-05-07,
40906174,305625,0,2048672,2024-05-08,2024-05-08,Groceries
40906174,0,393515,2442187,2024-05-08,2024-05-08,
40906174,0,365346,2807533,2024-05-08,2024-05-08,
40906174,446997,0,2360536,2024-05-09,2024-05-09,Transportation
40906174,0,341613,2702149,2024-05-09,2024-05-09,
40906174,0,359102,3061251,2024-05-10,2024-05-10,
40906174,19237,0,3042014,2024-05-11,2024-05-11,Education
40906174,0,423105,3465119,2024-05-11,2024-05-11,
40906174,0,19828,3484947,2024-05-12,2024-05-12,
40906174,0,300067,3785014,2024-05-12,2024-05-12,
40906174,0,481543,4266557,2024-05-12,2024-05-12,
40906174,662576,0,3898797,2024-05-13,2024-05-13,Education
40906174,0,12690,3911487,2024-05-13,2024-05-13,
40906174,0,493300,4404787,2024-05-14,2024-05-14,
40906174,0,330460,4735247,2024-05-15,2024-05-15,
40906174,0,10323,4745570,2024-05-15,2024-05-15,
40906174,18065,0,4727505,2024-05-16,2024-05-16,Groceries
40906174,0,309083,5036588,2024-05-16,2024-05-16,
40906174,17926,0,5018662,2024-05-16,2024-05-16,Utilities
40906174,0,321394,5340056,2024-05-17,2024-05-17,
40906174,0,410628,5750684,2024-05-17,2024-05-17,
40906174,0,353754,6104438,2024-05-17,2024-05-17,
40906174,0,12452,6116890,2024-05-18,2024-05-18,
40906174,19639,0,6097251,2024-05-19,2024-05-19,Rent
40906174,418387,0,5678864,2024-05-19,2024-05-19,Utilities
40906174,329407,0,5349457,2024-05-19,2024-05-19,Education
40906174,0,339214,5688671,2024-05-20,2024-05-20,
40906174,17173,0,5671498,2024-05-20,2024-05-20,Rent
40906174,314738,0,5356760,2024-05-20,2024-05-20,Education
40906174,344999,0,5011761,2024-05-21,2024-05-21,Transportation
40906174,0,494941,5506702,2024-05-21,2024-05-21,
40906174,11634,0,5495068,2024-05-21,2024-05-21,Clothes
40906174,0,331571,5826639,2024-05-22,2024-05-22,
40906174,0,492749,6319388,2024-05-22,2024-05-22,
40906174,14559,0,6304829,2024-05-22,2024-05-22,Rent
40906174,301165,0,6003664,2024-05-23,2024-05-23,Education
40906174,0,15716,6019380,2024-05-24,2024-05-24,
40906174,374556,0,5644824,2024-05-24,2024-05-24,Clothes
40906174,0,404758,6049582,2024-05-24,2024-05-24,
40906174,12132,0,6037450,2024-05-25,2024-05-25,Groceries
40906174,0,957600,6451498,2024-05-25,2024-05-25,
40906174,426541,0,6024957,2024-05-25,2024-05-25,Rent
40906174,0,434301,6459258,2024-05-26,2024-05-26,
40906174,0,418365,6877623,2024-05-26,2024-05-26,
40906174,0,420718,7298341,2024-05-27,2024-05-27,
40906174,0,12854,7311195,2024-05-27,2024-05-27,
40906174,0,309375,7620570,2024-05-28,2024-05-28,
40906174,0,15151,7635721,2024-05-28,2024-05-28,
40906174,18870,0,7616851,2024-05-28,2024-05-28,Education
40906174,466245,0,7150606,2024-05-29,2024-05-29,Education
40906174,0,338122,7488728,2024-05-29,2024-05-29,
40906174,323259,0,7165469,2024-05-29,2024-05-29,Groceries
40906174,19686,0,7145783,2024-05-30,2024-05-30,Education
40906174,0,11604,7157387,2024-05-31,2024-05-31,
40906174,483365,0,6674022,2024-06-01,2024-06-01,Bill Sharing
40906174,977243,0,6691785,2024-06-01,2024-06-01,Healthcare
40906174,0,354091,7045876,2024-06-02,2024-06-02,
40906174,14073,0,7031803,2024-06-02,2024-06-02,Utilities
40906174,0,14266,7046069,2024-06-03,2024-06-03,
40906174,0,412139,7458208,2024-06-03,2024-06-03,
40906174,0,17641,7475849,2024-06-04,2024-06-04,
40906174,0,359051,7834900,2024-06-04,2024-06-04,
40906174,12568,0,7822332,2024-06-04,2024-06-04,Education
40906174,16260,0,7806072,2024-06-05,2024-06-05,Utilities
40906174,0,17231,7823303,2024-06-06,2024-06-06,
40906174,12450,0,7810853,2024-06-06,2024-06-06,Transportation
40906174,0,12062,7822915,2024-06-06,2024-06-06,
40906174,0,471840,8294755,2024-06-07,2024-06-07,
40906174,18704,0,8276051,2024-06-07,2024-06-07,Bill Sharing
40906174,11155,0,8264896,2024-06-08,2024-06-08,Entertainment
40906174,0,12120,8277016,2024-06-08,2024-06-08,
40906174,390869,0,7886147,2024-06-09,2024-06-09,Bill Sharing
40906174,343521,0,7542626,2024-06-09,2024-06-09,Groceries
40906174,0,428868,7971494,2024-06-09,2024-06-09,
40906174,0,430184,8401678,2024-06-10,2024-06-10,
40906174,301708,0,8099970,2024-06-10,2024-06-10,Education
40906174,424837,0,7675133,2024-06-10,2024-06-10,Entertainment
40906174,18739,0,7656394,2024-06-11,2024-06-11,Clothes
40906174,313515,0,7342879,2024-06-11,2024-06-11,Groceries
40906174,393705,0,6949174,2024-06-12,2024-06-12,Entertainment
40906174,10836,0,6938338,2024-06-12,2024-06-12,Healthcare
40906174,466499,0,6471839,2024-06-12,2024-06-12,Education
40906174,10370,0,6461469,2024-06-13,2024-06-13,Rent
40906174,374629,0,6086840,2024-06-13,2024-06-13,Transportation
40906174,11588,0,6075252,2024-06-13,2024-06-13,Entertainment
40906174,415547,0,5659705,2024-06-14,2024-06-14,Utilities
40906174,0,15743,5675448,2024-06-14,2024-06-14,
40906174,0,13976,5689424,2024-06-15,2024-06-15,
40906174,0,18125,5707549,2024-06-15,2024-06-15,
40906174,17039,0,5690510,2024-06-16,2024-06-16,Bill Sharing
40906174,0,801615,5341411,2024-06-17,2024-06-17,
40906174,468801,0,4872610,2024-06-18,2024-06-18,Groceries
40906174,477797,0,4394813,2024-06-18,2024-06-18,Bill Sharing
40906174,0,416489,4811302,2024-06-19,2024-06-19,
40906174,0,19013,4830315,2024-06-19,2024-06-19,
40906174,0,364842,5195157,2024-06-19,2024-06-19,
40906174,18181,0,5176976,2024-06-20,2024-06-20,Bill Sharing
40906174,12972,0,5164004,2024-06-21,2024-06-21,Healthcare
40906174,337438,0,4826566,2024-06-21,2024-06-21,Healthcare
40906174,0,347769,5174335,2024-06-21,2024-06-21,
40906174,0,394588,5568923,2024-06-22,2024-06-22,
40906174,0,14649,5583572,2024-06-23,2024-06-23,
40906174,308865,0,5274707,2024-06-23,2024-06-23,Groceries
40906174,0,553225,5260632,2024-06-23,2024-06-23,
40906174,498419,0,4762213,2024-06-24,2024-06-24,Bill Sharing
40906174,480079,0,4282134,2024-06-25,2024-06-25,Healthcare
40906174,10283,0,4271851,2024-06-25,2024-06-25,Entertainment
40906174,391326,0,3880525,2024-06-25,2024-06-25,Bill Sharing
40906174,0,357046,4237571,2024-06-26,2024-06-26,
40906174,390511,0,3847060,2024-06-26,2024-06-26,Healthcare
40906174,0,319533,4166593,2024-06-27,2024-06-27,
40906174,0,340643,4507236,2024-06-28,2024-06-28,
40906174,428667,0,4078569,2024-06-28,2024-06-28,Transportation
40906174,15891,0,4062678,2024-06-28,2024-06-28,Entertainment
40906174,0,14042,4076720,2024-06-29,2024-06-29,
40906174,341018,0,3735702,2024-06-29,2024-06-29,Bill Sharing
40906174,371313,0,3364389,2024-06-29,2024-06-29,Groceries
40906174,329925,0,3034464,2024-06-30,2024-06-30,Bill Sharing
40906174,440546,0,2593918,2024-07-01,2024-07-01,Rent
40906174,18346,0,2575572,2024-07-01,2024-07-01,Rent
40906174,15370,0,2560202,2024-07-02,2024-07-02,Education
40906174,310934,0,2249268,2024-07-02,2024-07-02,Education
40906174,0,15584,2264852,2024-07-03,2024-07-03,
40906174,0,19496,2284348,2024-07-03,2024-07-03,
40906174,334257,0,1950091,2024-07-04,2024-07-04,Education
40906174,499904,0,1450187,2024-07-04,2024-07-04,Bill Sharing
40906174,0,417946,1868133,2024-07-05,2024-07-05,
40906174,0,16517,1884650,2024-07-06,2024-07-06,
40906174,0,11777,1896427,2024-07-07,2024-07-07,
40906174,352175,0,1544252,2024-07-07,2024-07-07,Healthcare
40906174,0,17628,1561880,2024-07-07,2024-07-07,
40906174,0,16419,1578299,2024-07-08,2024-07-08,
40906174,367347,0,1210952,2024-07-08,2024-07-08,Groceries
40906174,0,19564,1230516,2024-07-08,2024-07-08,
40906174,314993,0,915523,2024-07-09,2024-07-09,Education
40906174,0,19155,934678,2024-07-09,2024-07-09,
40906174,17670,0,917008,2024-07-10,2024-07-10,Groceries
40906174,11148,0,905860,2024-07-10,2024-07-10,Groceries
40906174,435931,0,469929,2024-07-10,2024-07-10,Education
40906174,325969,0,143960,2024-07-11,2024-07-11,Groceries
40906174,0,525959,160372,2024-07-11,2024-07-11,
40906174,451700,0,10000,2024-07-11,2024-07-11,Groceries
40906174,14307,0,10000,2024-07-12,2024-07-12,Education
40906174,0,17907,27907,2024-07-13,2024-07-13,
40906174,486097,0,10000,2024-07-14,2024-07-14,Transportation
40906174,0,15387,25387,2024-07-14,2024-07-14,
40906174,0,355362,380749,2024-07-15,2024-07-15,
40906174,0,488402,869151,2024-07-16,2024-07-16,
40906174,11722,0,857429,2024-07-16,2024-07-16,Utilities
40906174,0,11774,869203,2024-07-16,2024-07-16,
40906174,0,485664,1354867,2024-07-17,2024-07-17,
40906174,0,452315,1807182,2024-07-17,2024-07-17,
40906174,449634,0,1357548,2024-07-17,2024-07-17,Rent
40906174,0,366838,1724386,2024-07-18,2024-07-18,
40906174,455686,0,1419841,2024-07-18,2024-07-18,Healthcare
40906174,0,308363,1728204,2024-07-18,2024-07-18,
40906174,346747,0,1381457,2024-07-19,2024-07-19,Groceries
40906174,17253,0,1364204,2024-07-19,2024-07-19,Transportation
40906174,13270,0,1350934,2024-07-20,2024-07-20,Clothes
40906174,0,469295,1820229,2024-07-20,2024-07-20,
40906174,16859,0,1803370,2024-07-21,2024-07-21,Entertainment
40906174,11643,0,1791727,2024-07-21,2024-07-21,Groceries
40906174,12032,0,1779695,2024-07-22,2024-07-22,Transportation
40906174,0,18959,1798654,2024-07-22,2024-07-22,
40906174,0,418293,2216947,2024-07-23,2024-07-23,
40906174,16640,0,2200307,2024-07-23,2024-07-23,Entertainment
40906174,394640,0,1805667,2024-07-23,2024-07-23,Rent
40906174,0,11518,1817185,2024-07-24,2024-07-24,
40906174,16717,0,1800468,2024-07-25,2024-07-25,Clothes
40906174,461649,0,1338819,2024-07-25,2024-07-25,Utilities
40906174,16407,0,1322412,2024-07-25,2024-07-25,Education
40906174,16817,0,1305595,2024-07-26,2024-07-26,Rent
40906174,458280,0,847315,2024-07-26,2024-07-26,Groceries
40906174,386021,0,461294,2024-07-26,2024-07-26,Rent
40906174,0,389307,850601,2024-07-27,2024-07-27,
40906174,472534,0,378067,2024-07-27,2024-07-27,Transportation
40906174,0,16037,394104,2024-07-28,2024-07-28,
40906174,0,15486,409590,2024-07-28,2024-07-28,
40906174,10682,0,398908,2024-07-28,2024-07-28,Groceries
40906174,424583,0,10000,2024-07-29,2024-07-29,Entertainment
40906174,14658,0,10000,2024-07-30,2024-07-30,Clothes
40906174,13569,0,10000,2024-07-31,2024-07-31,Rent
40906174,0,16991,26991,2024-07-31,2024-07-31,
40906174,358661,0,10000,2024-07-31,2024-07-31,Groceries
40906174,0,12557,22557,2024-08-01,2024-08-01,
40906174,310188,0,10000,2024-08-02,2024-08-02,Healthcare
40906174,14877,0,10000,2024-08-03,2024-08-03,Healthcare
40906174,0,14831,24831,2024-08-04,2024-08-04,
40906174,0,14982,39813,2024-08-05,2024-08-05,
40906174,0,19597,59410,2024-08-05,2024-08-05,
40906174,303192,0,10000,2024-08-06,2024-08-06,Rent
40906174,304149,0,10000,2024-08-07,2024-08-07,Clothes
40906174,0,475004,485004,2024-08-07,2024-08-07,
40906174,0,367215,852219,2024-08-07,2024-08-07,
40906174,399880,0,452339,2024-08-08,2024-08-08,Entertainment
40906174,13331,0,439008,2024-08-08,2024-08-08,Clothes
40906174,0,17913,456921,2024-08-08,2024-08-08,
40906174,0,10947,467868,2024-08-09,2024-08-09,
40906174,0,14492,482360,2024-08-09,2024-08-09,
40906174,16359,0,466001,2024-08-09,2024-08-09,Clothes
40906174,0,544052,454148,2024-08-10,2024-08-10,
40906174,0,10057,464205,2024-08-11,2024-08-11,
40906174,0,18829,483034,2024-08-11,2024-08-11,
40906174,408774,0,74260,2024-08-12,2024-08-12,Groceries
40906174,11803,0,62457,2024-08-12,2024-08-12,Education
40906174,0,18499,80956,2024-08-13,2024-08-13,
40906174,355922,0,10000,2024-08-14,2024-08-14,Groceries
40906174,348577,0,10000,2024-08-14,2024-08-14,Transportation
40906174,11511,0,10000,2024-08-14,2024-08-14,Transportation
40906174,17455,0,10000,2024-08-15,2024-08-15,Transportation
40906174,0,13357,23357,2024-08-16,2024-08-16,
40906174,0,340971,364328,2024-08-16,2024-08-16,
40906174,15165,0,349163,2024-08-16,2024-08-16,Utilities
40906174,0,346689,695852,2024-08-17,2024-08-17,
40906174,0,420612,1116464,2024-08-18,2024-08-18,
40906174,439163,0,677301,2024-08-18,2024-08-18,Groceries
40906174,0,16078,693379,2024-08-18,2024-08-18,
